Squad,Unnamed: 1_level_0 # Pl_for,Unnamed: 2_level_0 90s_for,Tackles Tkl_for,Tackles TklW_for,Tackles Def 3rd_for,Tackles Mid 3rd_for,Tackles Att 3rd_for,Challenges Tkl_for,Challenges Att_for,Challenges Tkl%_for,Challenges Lost_for,Blocks Blocks_for,Blocks Sh_for,Blocks Pass_for,Unnamed: 15_level_0 Int_for,Unnamed: 16_level_0 Tkl+Int_for,Unnamed: 17_level_0 Clr_for,Unnamed: 18_level_0 Err_for,Unnamed: 1_level_0 # Pl_against,Unnamed: 2_level_0 90s_against,Tackles Tkl_against,Tackles TklW_against,Tackles Def 3rd_against,Tackles Mid 3rd_against,Tackles Att 3rd_against,Challenges Tkl_against,Challenges Att_against,Challenges Tkl%_against,Challenges Lost_against,Blocks Blocks_against,Blocks Sh_against,Blocks Pass_against,Unnamed: 15_level_0 Int_against,Unnamed: 16_level_0 Tkl+Int_against,Unnamed: 17_level_0 Clr_against,Unnamed: 18_level_0 Err_against,Season
Arsenal,25,38.0,598,348,220,249,129,260,515,50.5,255,328,106,222,225,823,680,33,25,38.0,698,420,406,214,78,316,636,49.7,320,410,180,230,261,959,1038,38,2024-2025 Premier League
Aston Villa,28,38.0,637,372,293,249,95,310,546,56.8,236,329,107,222,240,877,788,43,28,38.0,685,387,322,258,105,299,626,47.8,327,419,136,283,347,1032,869,30,2024-2025 Premier League
Bournemouth,29,38.0,691,399,290,299,102,301,627,48.0,326,459,136,323,351,1042,1013,22,29,38.0,650,396,321,257,72,300,594,50.5,294,414,160,254,279,929,1014,50,2024-2025 Premier League
Brentford,28,38.0,633,380,289,223,121,314,596,52.7,282,480,199,281,285,918,1040,28,28,38.0,593,362,273,217,103,293,558,52.5,265,366,106,260,287,880,1036,32,2024-2025 Premier League
Brighton,32,38.0,705,431,287,297,121,350,703,49.8,353,439,122,317,315,1020,762,29,32,38.0,726,408,370,274,82,382,720,53.1,338,409,147,262,320,1046,981,33,2024-2025 Premier League
Chelsea,29,38.0,588,371,243,244,101,273,536,50.9,263,356,103,253,272,860,695,45,29,38.0,633,368,318,241,74,336,662,50.8,326,435,172,263,286,919,880,42,2024-2025 Premier League
Crystal Palace,29,38.0,767,450,374,299,94,324,643,50.4,319,485,144,341,334,1101,1088,19,29,38.0,580,319,203,264,113,241,450,53.6,209,417,145,272,342,922,874,35,2024-2025 Premier League
Everton,26,38.0,732,433,366,269,97,338,656,51.5,318,392,138,254,345,1077,1088,25,26,38.0,695,424,322,276,97,305,588,51.9,283,349,103,246,235,930,924,25,2024-2025 Premier League
Fulham,26,38.0,679,411,327,259,93,289,565,51.2,276,382,113,269,302,981,914,33,26,38.0,535,306,237,226,72,254,542,46.9,288,423,148,275,336,871,995,27,2024-2025 Premier League
Ipswich Town,32,38.0,589,340,294,214,81,281,604,46.5,323,436,185,251,303,892,1102,39,32,38.0,637,366,274,260,103,290,567,51.1,277,366,110,256,242,879,744,23,2024-2025 Premier League
Leicester City,32,38.0,728,431,361,278,89,336,695,48.3,359,505,198,307,327,1055,987,31,32,38.0,640,411,223,288,129,304,568,53.5,264,355,95,260,269,909,807,23,2024-2025 Premier League
Liverpool,24,38.0,642,391,271,267,104,340,656,51.8,316,367,97,270,299,941,724,31,24,38.0,660,402,358,228,74,310,611,50.7,301,462,183,279,320,980,1094,42,2024-2025 Premier League
Manchester City,30,38.0,497,299,183,216,98,214,449,47.7,235,331,89,242,229,726,619,35,30,38.0,696,399,418,214,64,301,678,44.4,377,462,172,290,310,1006,956,33,2024-2025 Premier League
Manchester Utd,31,38.0,817,493,394,305,118,400,723,55.3,323,386,107,279,358,1175,759,26,31,38.0,676,414,315,257,104,323,575,56.2,252,475,164,311,325,1001,858,20,2024-2025 Premier League
Newcastle Utd,24,38.0,603,371,275,235,93,306,604,50.7,298,411,141,270,270,873,884,34,24,38.0,736,433,327,298,111,298,580,51.4,282,462,150,312,301,1037,893,44,2024-2025 Premier League
Nott'ham Forest,23,38.0,698,419,406,225,67,343,670,51.2,327,427,157,270,322,1020,1220,24,23,38.0,557,365,252,211,94,233,492,47.4,259,356,122,234,265,822,896,37,2024-2025 Premier League
Southampton,36,38.0,652,378,310,266,76,280,584,47.9,304,433,201,232,305,957,988,51,36,38.0,688,405,257,294,137,333,645,51.6,312,359,124,235,311,999,753,11,2024-2025 Premier League
Tottenham,31,38.0,661,414,285,271,105,296,598,49.5,302,448,159,289,322,983,821,41,31,38.0,851,548,402,336,113,425,733,58.0,308,509,137,372,391,1242,903,36,2024-2025 Premier League
West Ham,27,38.0,654,388,317,253,84,290,532,54.5,242,440,169,271,331,985,1037,28,27,38.0,752,435,322,310,120,360,707,50.9,347,431,144,287,298,1050,836,23,2024-2025 Premier League
Wolves,32,38.0,801,471,412,305,84,373,669,55.8,296,437,137,300,298,1099,947,25,32,38.0,684,422,277,300,107,315,639,49.3,324,392,110,282,308,992,805,38,2024-2025 Premier League
Atalanta,32,38.0,571,347,238,260,73,272,506,53.8,234,360,98,262,296,867,679,16,32,38.0,692,399,381,244,67,330,587,56.2,257,387,125,262,330,1022,895,28,2024-2025 Serie A
Bologna,30,38.0,591,346,215,270,106,283,538,52.6,255,390,93,297,258,849,679,20,30,38.0,627,375,320,253,54,266,487,54.6,221,391,136,255,305,932,999,22,2024-2025 Serie A
Cagliari,28,38.0,538,303,264,224,50,238,449,53.0,211,343,131,212,276,814,887,18,28,38.0,568,338,270,220,78,274,502,54.6,228,396,117,279,268,836,920,16,2024-2025 Serie A
Como,38,38.0,663,412,301,260,102,303,591,51.3,288,348,91,257,279,942,788,19,38,38.0,648,385,260,287,101,288,552,52.2,264,453,139,314,325,973,757,28,2024-2025 Serie A
Empoli,34,38.0,689,396,314,293,82,309,543,56.9,234,396,136,260,323,1012,1072,21,34,38.0,587,373,271,250,66,238,450,52.9,212,355,110,245,255,842,918,17,2024-2025 Serie A
Fiorentina,34,38.0,531,311,267,195,69,248,488,50.8,240,353,123,230,269,800,911,17,34,38.0,560,306,260,222,78,254,524,48.5,270,349,111,238,233,793,770,27,2024-2025 Serie A
Genoa,37,38.0,672,385,281,287,104,283,566,50.0,283,422,126,296,308,980,938,15,37,38.0,549,326,230,255,64,260,447,58.2,187,367,98,269,284,833,854,22,2024-2025 Serie A
Hellas Verona,32,38.0,672,434,326,271,75,311,592,52.5,281,393,123,270,329,1001,987,23,32,38.0,487,263,242,179,66,233,461,50.5,228,337,101,236,221,708,734,18,2024-2025 Serie A
Inter,26,38.0,505,278,215,198,92,239,452,52.9,213,356,126,230,223,728,676,11,26,38.0,441,263,193,184,64,199,357,55.7,158,392,144,248,253,694,887,19,2024-2025 Serie A
Juventus,29,38.0,606,353,273,245,88,263,471,55.8,208,404,139,265,215,821,723,27,29,38.0,593,359,265,239,89,300,609,49.3,309,383,144,239,298,891,797,21,2024-2025 Serie A
Lazio,27,38.0,520,319,234,224,62,251,501,50.1,250,313,90,223,295,815,718,23,27,38.0,576,332,263,225,88,266,562,47.3,296,356,134,222,272,848,985,24,2024-2025 Serie A
Lecce,31,38.0,627,372,315,250,62,301,584,51.5,283,407,144,263,285,912,1042,26,31,38.0,538,327,226,229,83,248,485,51.1,237,375,106,269,292,830,807,23,2024-2025 Serie A
Milan,35,38.0,552,349,249,222,81,246,480,51.3,234,292,95,197,234,786,691,21,35,38.0,597,339,309,224,64,309,652,47.4,343,364,160,204,291,888,803,23,2024-2025 Serie A
Monza,36,38.0,562,315,304,202,56,272,501,54.3,229,382,157,225,305,867,874,38,36,38.0,561,336,206,257,98,227,447,50.8,220,312,77,235,225,786,768,11,2024-2025 Serie A
Napoli,27,38.0,535,323,237,238,60,258,469,55.0,211,317,100,217,270,805,813,11,27,38.0,612,366,300,238,74,286,530,54.0,244,446,160,286,330,942,845,26,2024-2025 Serie A
Parma,32,38.0,523,293,267,201,55,242,484,50.0,242,434,153,281,279,802,977,21,32,38.0,573,354,293,216,64,276,525,52.6,249,330,112,218,279,852,739,13,2024-2025 Serie A
Roma,28,38.0,551,328,233,236,82,224,439,51.0,215,329,110,219,282,833,746,16,28,38.0,549,328,278,202,69,266,476,55.9,210,398,150,248,261,810,838,19,2024-2025 Serie A
Torino,31,38.0,468,261,217,181,70,232,437,53.1,205,338,133,205,278,746,882,21,31,38.0,508,293,219,218,71,236,405,58.3,169,334,115,219,289,797,887,22,2024-2025 Serie A
Udinese,31,38.0,562,346,276,217,69,279,508,54.9,229,396,139,257,302,864,909,27,31,38.0,589,350,275,238,76,294,575,51.1,281,326,109,217,270,859,887,15,2024-2025 Serie A
Venezia,36,38.0,605,361,319,202,84,286,572,50.0,286,439,145,294,279,884,921,25,36,38.0,688,420,284,296,108,290,538,53.9,248,361,104,257,304,992,823,22,2024-2025 Serie A
Angers,30,34.0,624,392,340,202,82,294,607,48.4,313,365,116,249,336,960,903,20,30,34.0,628,389,241,275,112,331,580,57.1,249,315,87,228,251,879,674,22,2024-2025 Ligue 1
Auxerre,29,34.0,657,403,330,232,95,316,606,52.1,290,394,125,269,350,1007,944,17,29,34.0,670,414,293,257,120,324,582,55.7,258,355,91,264,279,949,702,17,2024-2025 Ligue 1
Brest,30,34.0,656,426,291,255,110,308,583,52.8,275,363,105,258,316,972,869,14,30,34.0,491,294,223,204,64,245,454,54.0,209,347,88,259,300,791,808,22,2024-2025 Ligue 1
Le Havre,31,34.0,621,387,326,212,83,304,562,54.1,258,362,131,231,324,945,987,24,31,34.0,547,314,213,239,95,236,469,50.3,233,301,83,218,249,796,788,20,2024-2025 Ligue 1
Lens,33,34.0,606,365,264,233,109,299,579,51.6,280,387,101,286,321,927,705,19,33,34.0,638,361,296,247,95,297,546,54.4,249,443,144,299,361,999,942,17,2024-2025 Ligue 1
Lille,27,34.0,626,356,241,273,112,311,554,56.1,243,302,74,228,271,897,637,22,27,34.0,588,364,300,229,59,288,571,50.4,283,388,113,275,374,962,777,25,2024-2025 Ligue 1
Lyon,31,34.0,576,340,257,230,89,310,595,52.1,285,346,113,233,282,858,695,25,31,34.0,558,345,303,181,74,277,515,53.8,238,429,115,314,319,877,864,10,2024-2025 Ligue 1
Marseille,32,34.0,552,358,244,229,79,274,472,58.1,198,272,70,202,280,832,523,31,32,34.0,613,372,270,245,98,300,578,51.9,278,404,128,276,335,948,784,27,2024-2025 Ligue 1
Monaco,28,34.0,670,429,281,287,102,339,624,54.3,285,350,70,280,357,1027,667,18,28,34.0,641,389,306,257,78,300,566,53.0,266,391,130,261,368,1009,892,30,2024-2025 Ligue 1
Montpellier,35,34.0,631,389,302,264,65,310,608,51.0,298,368,123,245,273,904,733,25,35,34.0,598,366,263,230,105,302,564,53.5,262,326,103,223,280,878,858,21,2024-2025 Ligue 1
Nantes,30,34.0,645,376,338,224,83,321,565,56.8,244,402,116,286,283,928,1007,10,30,34.0,564,350,299,191,74,278,505,55.0,227,316,92,224,221,785,857,18,2024-2025 Ligue 1
Nice,31,34.0,633,399,297,242,94,297,534,55.6,237,417,127,290,365,998,784,32,31,34.0,661,449,285,288,88,346,641,54.0,295,390,121,269,312,973,774,19,2024-2025 Ligue 1
Paris S-G,28,34.0,619,386,242,266,111,325,607,53.5,282,360,103,257,265,884,493,19,28,34.0,722,454,419,233,70,393,757,51.9,364,420,142,278,338,1060,740,28,2024-2025 Ligue 1
Reims,34,34.0,558,359,313,174,71,285,551,51.7,266,392,145,247,289,847,958,20,34,34.0,616,371,283,233,100,312,591,52.8,279,332,122,210,270,886,823,9,2024-2025 Ligue 1
Rennes,35,34.0,596,363,282,234,80,296,510,58.0,214,350,96,254,337,933,739,14,35,34.0,671,411,333,241,97,327,597,54.8,270,376,111,265,356,1027,774,18,2024-2025 Ligue 1
Saint-Étienne,32,34.0,581,382,291,216,74,296,594,49.8,298,404,135,269,328,909,854,26,32,34.0,603,402,302,199,102,294,533,55.2,239,340,104,236,317,920,634,15,2024-2025 Ligue 1
Strasbourg,30,34.0,537,335,256,213,68,257,459,56.0,202,376,111,265,282,819,899,17,30,34.0,567,366,247,217,103,304,586,51.9,282,324,90,234,312,879,612,25,2024-2025 Ligue 1
Toulouse,27,34.0,605,364,264,253,88,318,608,52.3,290,341,103,238,281,886,775,15,27,34.0,617,398,283,273,61,306,583,52.5,277,354,100,254,298,915,869,25,2024-2025 Ligue 1
Augsburg,29,34.0,464,300,198,202,64,233,430,54.2,197,417,121,296,341,805,971,16,29,34.0,577,357,254,250,73,280,508,55.1,228,418,97,321,270,847,857,17,2024-2025 Bundesliga
Bayern Munich,29,34.0,506,300,166,233,107,250,450,55.6,200,318,52,266,232,738,518,23,29,34.0,618,353,335,210,73,354,737,48.0,383,473,163,310,404,1022,942,30,2024-2025 Bundesliga
Bochum,27,34.0,600,360,318,207,75,306,572,53.5,266,475,142,333,294,894,906,23,27,34.0,474,308,211,203,60,239,406,58.9,167,430,125,305,300,774,1068,17,2024-2025 Bundesliga
Dortmund,28,34.0,523,319,232,196,95,261,492,53.0,231,375,100,275,249,772,726,18,28,34.0,641,374,348,235,58,334,675,49.5,341,429,146,283,312,953,908,25,2024-2025 Bundesliga
Eint Frankfurt,26,34.0,566,341,267,219,80,280,508,55.1,228,425,128,297,287,853,994,26,26,34.0,534,323,268,185,81,272,565,48.1,293,408,125,283,264,798,793,27,2024-2025 Bundesliga
Freiburg,26,34.0,511,317,225,222,64,235,457,51.4,222,400,112,288,276,787,811,21,26,34.0,496,298,205,211,80,237,452,52.4,215,397,122,275,260,756,916,18,2024-2025 Bundesliga
Gladbach,26,34.0,504,284,278,177,49,240,473,50.7,233,445,166,279,317,821,1067,23,26,34.0,500,303,203,222,75,231,437,52.9,206,436,112,324,302,802,787,25,2024-2025 Bundesliga
Heidenheim,27,34.0,614,356,322,235,57,294,558,52.7,264,435,109,326,312,926,952,15,27,34.0,490,303,189,231,70,250,482,51.9,232,397,99,298,243,733,813,19,2024-2025 Bundesliga
Hoffenheim,35,34.0,570,336,266,236,68,269,511,52.6,242,450,139,311,291,861,922,22,35,34.0,531,321,230,232,69,238,472,50.4,234,405,115,290,273,804,1051,13,2024-2025 Bundesliga
Holstein Kiel,27,34.0,541,328,292,174,75,277,530,52.3,253,409,155,254,294,835,1126,22,27,34.0,442,258,154,180,108,200,384,52.1,184,359,90,269,237,679,753,23,2024-2025 Bundesliga
Leverkusen,23,34.0,395,259,153,163,79,184,357,51.5,173,302,77,225,234,629,676,26,23,34.0,546,313,310,183,53,293,547,53.6,254,417,145,272,352,898,933,18,2024-2025 Bundesliga
Mainz 05,25,34.0,564,325,234,247,83,236,448,52.7,212,419,128,291,352,916,947,22,25,34.0,547,349,263,212,72,252,466,54.1,214,435,119,316,303,850,1046,23,2024-2025 Bundesliga
RB Leipzig,29,34.0,543,333,248,222,73,258,525,49.1,267,500,156,344,268,811,990,29,29,34.0,572,329,249,241,82,260,521,49.9,261,443,111,332,298,870,869,21,2024-2025 Bundesliga
St. Pauli,28,34.0,537,315,256,217,64,266,511,52.1,245,391,87,304,257,794,915,21,28,34.0,463,275,214,196,53,201,380,52.9,179,380,125,255,244,707,908,28,2024-2025 Bundesliga
Stuttgart,29,34.0,477,282,197,199,81,254,476,53.4,222,401,104,297,298,775,777,20,29,34.0,584,347,298,231,55,272,536,50.7,264,379,125,254,303,887,887,14,2024-2025 Bundesliga
Union Berlin,28,34.0,537,318,266,223,48,270,507,53.3,237,409,110,299,312,849,1046,13,28,34.0,500,289,230,200,70,214,386,55.4,172,394,104,290,250,750,940,21,2024-2025 Bundesliga
Werder Bremen,23,34.0,551,321,245,240,66,276,521,53.0,245,454,144,310,315,866,851,27,23,34.0,496,306,218,202,76,240,435,55.2,195,440,122,318,317,813,873,18,2024-2025 Bundesliga
Wolfsburg,27,34.0,491,301,257,175,59,246,540,45.6,294,435,133,302,312,803,977,19,27,34.0,483,289,241,163,79,268,477,56.2,209,420,118,302,309,792,828,29,2024-2025 Bundesliga
Alavés,29,38.0,737,459,346,307,84,348,726,47.9,378,382,96,286,309,1046,918,10,29,38.0,552,328,258,224,70,245,430,57.0,185,380,89,291,287,839,1123,16,2024-2025
Athletic Club,31,38.0,577,345,240,252,85,296,579,51.1,283,353,72,281,344,921,911,25,31,38.0,789,471,428,289,72,388,716,54.2,328,348,112,236,361,1150,951,24,2024-2025
Atlético Madrid,24,38.0,619,375,305,238,76,319,627,50.9,308,358,97,261,260,879,818,25,24,38.0,579,365,276,206,97,305,581,52.5,276,437,110,327,369,948,969,35,2024-2025
Barcelona,28,38.0,538,332,186,245,107,271,520,52.1,249,329,60,269,227,765,601,14,28,38.0,691,405,378,245,68,375,830,45.2,455,497,175,322,381,1072,1016,38,2024-2025
Betis,36,38.0,645,397,271,273,101,342,644,53.1,302,406,113,293,356,1001,910,19,36,38.0,722,459,362,285,75,344,656,52.4,312,458,132,326,332,1054,866,19,2024-2025
Celta Vigo,30,38.0,555,340,258,217,80,286,576,49.7,290,345,91,254,282,837,828,30,30,38.0,608,382,307,234,67,312,566,55.1,254,454,122,332,390,998,740,17,2024-2025
Espanyol,27,38.0,640,397,380,210,50,310,610,50.8,300,435,155,280,315,955,1131,21,27,38.0,507,309,234,209,64,266,487,54.6,221,346,97,249,292,799,773,20,2024-2025
Getafe,30,38.0,645,393,287,278,80,333,665,50.1,332,411,84,327,276,921,1065,15,30,38.0,669,391,357,248,64,312,577,54.1,265,351,127,224,282,951,1230,22,2024-2025
Girona,30,38.0,569,348,268,219,82,292,557,52.4,265,327,104,223,279,848,722,34,30,38.0,588,348,291,199,98,276,567,48.7,291,381,108,273,277,865,911,15,2024-2025
Las Palmas,34,38.0,619,370,308,253,58,307,592,51.9,285,434,139,295,321,940,971,28,34,38.0,563,360,253,230,80,288,527,54.6,239,353,100,253,307,870,974,19,2024-2025
Leganés,26,38.0,633,384,301,250,82,295,599,49.2,304,436,157,279,332,965,1201,18,26,38.0,577,351,247,253,77,263,565,46.5,302,291,80,211,279,856,768,20,2024-2025
Mallorca,28,38.0,584,361,305,211,68,257,500,51.4,243,389,153,236,326,910,1161,17,28,38.0,637,402,269,287,81,260,515,50.5,255,338,87,251,272,909,947,16,2024-2025
Osasuna,25,38.0,614,365,296,239,79,311,618,50.3,307,388,102,286,266,880,918,16,25,38.0,572,385,297,206,69,279,539,51.8,260,377,104,273,250,822,981,18,2024-2025
Rayo Vallecano,26,38.0,626,396,328,218,80,309,664,46.5,355,443,128,315,334,960,973,22,26,38.0,631,398,284,263,84,304,590,51.5,286,465,128,337,314,945,1004,24,2024-2025
Real Madrid,30,38.0,586,359,294,209,83,264,486,54.3,222,353,105,248,331,917,633,19,30,38.0,674,408,401,183,90,384,796,48.2,412,454,171,283,333,1007,824,24,2024-2025
Real Sociedad,31,38.0,649,401,309,244,96,308,579,53.2,271,428,120,308,283,932,913,21,31,38.0,604,377,306,219,79,307,602,51.0,295,401,99,302,292,896,1003,14,2024-2025
Sevilla,35,38.0,648,390,321,240,87,312,563,55.4,251,368,88,280,367,1015,931,17,35,38.0,651,375,306,260,85,320,659,48.6,339,385,110,275,283,934,890,22,2024-2025
Valencia,32,38.0,647,415,340,228,79,321,573,56.0,252,366,96,270,302,949,953,19,32,38.0,661,388,292,291,78,321,557,57.6,236,409,96,313,293,954,902,19,2024-2025
Valladolid,38,38.0,596,357,342,204,50,276,566,48.8,290,450,160,290,311,907,944,29,38,38.0,534,329,189,251,94,266,555,47.9,289,303,84,219,211,745,731,16,2024-2025
Villarreal,31,38.0,649,396,333,236,80,336,628,53.5,292,426,131,295,281,930,922,21,31,38.0,567,349,283,189,95,278,557,49.9,279,399,120,279,297,864,821,22,2024-2025
Alavés,30,38.0,578,347,284,227,67,290,629,46.1,339,363,117,246,279,857,810,5,30,38.0,553,340,279,216,58,254,564,45.0,310,393,115,278,233,786,802,14,2023-2024
Almería,35,38.0,633,372,354,222,57,280,582,48.1,302,430,134,296,313,946,856,19,35,38.0,583,364,249,236,98,314,613,51.2,299,357,103,254,280,863,676,15,2023-2024
Athletic Club,27,38.0,581,362,217,264,100,305,635,48.0,330,419,106,313,278,859,631,4,27,38.0,715,428,371,284,60,349,687,50.8,338,411,119,292,370,1085,843,27,2023-2024
Atlético Madrid,27,38.0,654,399,308,263,83,327,671,48.7,344,460,114,346,256,910,793,8,27,38.0,530,318,257,182,91,227,524,43.3,297,407,104,303,298,828,735,17,2023-2024
Barcelona,29,38.0,571,363,271,223,77,243,523,46.5,280,363,97,266,257,828,573,17,29,38.0,643,392,333,227,83,338,722,46.8,384,450,159,291,318,961,770,10,2023-2024
Betis,35,38.0,692,440,305,300,87,358,683,52.4,325,422,101,321,345,1037,801,9,35,38.0,756,464,337,343,76,329,715,46.0,386,484,144,340,314,1070,693,13,2023-2024
Cádiz,34,38.0,671,398,338,264,69,341,728,46.8,387,443,123,320,298,969,786,13,34,38.0,606,370,281,253,72,263,493,53.3,230,341,89,252,243,849,795,7,2023-2024
Celta Vigo,31,38.0,627,382,302,243,82,308,662,46.5,354,434,116,318,297,924,832,9,31,38.0,627,382,309,254,64,291,586,49.7,295,444,125,319,335,962,721,8,2023-2024
Getafe,33,38.0,608,364,269,251,88,291,577,50.4,286,342,103,239,307,915,730,6,33,38.0,540,348,267,228,45,260,499,52.1,239,382,113,269,261,801,855,17,2023-2024
Girona,25,38.0,544,340,264,222,58,274,521,52.6,247,378,124,254,257,801,661,21,25,38.0,673,423,315,235,123,297,650,45.7,353,374,104,270,301,974,630,10,2023-2024
Granada,40,38.0,637,374,336,237,64,289,623,46.4,334,404,110,294,280,917,779,26,40,38.0,601,344,270,262,69,296,599,49.4,303,390,106,284,290,891,729,11,2023-2024
Las Palmas,29,38.0,662,397,328,263,71,305,633,48.2,328,416,98,318,281,943,761,14,29,38.0,673,415,301,301,71,308,624,49.4,316,426,99,327,335,1008,656,7,2023-2024
Mallorca,25,38.0,686,388,347,281,58,340,657,51.8,317,369,131,238,365,1051,785,10,25,38.0,532,318,237,231,64,219,470,46.6,251,375,108,267,295,827,814,10,2023-2024
Osasuna,29,38.0,525,311,247,201,77,243,517,47.0,274,400,108,292,263,788,756,16,29,38.0,530,339,286,187,57,247,484,51.0,237,411,101,310,291,821,903,9,2023-2024
Rayo Vallecano,26,38.0,630,372,279,282,69,270,608,44.4,338,410,105,305,308,938,796,12,26,38.0,679,408,314,284,81,306,589,52.0,283,388,119,269,285,964,759,17,2023-2024
Real Madrid,27,38.0,557,368,252,214,91,225,461,48.8,236,401,104,297,296,853,552,14,27,38.0,705,389,393,221,91,393,794,49.5,401,402,146,256,296,1001,689,16,2023-2024
Real Sociedad,31,38.0,650,405,271,285,94,283,552,51.3,269,405,118,287,253,903,693,15,31,38.0,635,368,305,268,62,284,605,46.9,321,402,112,290,278,913,803,9,2023-2024
Sevilla,35,38.0,697,463,380,237,80,335,626,53.5,291,395,123,272,313,1010,772,9,35,38.0,558,347,247,240,71,278,570,48.8,292,367,88,279,236,794,895,10,2023-2024
Valencia,29,38.0,657,379,335,250,72,309,618,50.0,309,392,105,287,324,981,842,9,29,38.0,612,379,293,231,88,294,570,51.6,276,406,87,319,269,881,646,10,2023-2024
Villarreal,32,38.0,576,348,288,212,76,260,532,48.9,272,386,130,256,304,880,789,12,32,38.0,685,436,331,258,96,329,680,48.4,351,422,126,296,346,1031,584,11,2023-2024
Almería,29,38.0,557,322,292,202,63,280,623,44.9,343,435,122,313,322,879,855,13,29,38.0,591,369,274,233,84,310,606,51.2,296,373,108,265,249,840,553,14,2022-2023
Athletic Club,26,38.0,608,369,267,254,87,322,642,50.2,320,415,95,320,310,918,598,14,26,38.0,656,416,374,212,70,305,652,46.8,347,449,147,302,384,1040,839,17,2022-2023
Atlético Madrid,27,38.0,667,408,332,245,90,334,685,48.8,351,396,103,293,304,971,704,9,27,38.0,539,317,271,181,87,262,584,44.9,322,445,134,311,368,907,663,14,2022-2023
Barcelona,29,38.0,522,324,211,216,95,227,498,45.6,271,353,82,271,253,775,439,17,29,38.0,647,385,332,250,65,321,717,44.8,396,423,139,284,369,1016,746,17,2022-2023
Betis,30,38.0,665,421,373,238,54,338,701,48.2,363,411,112,299,364,1029,857,7,30,38.0,664,417,303,268,93,311,676,46.0,365,437,95,342,324,988,584,9,2022-2023
Cádiz,38,38.0,623,410,358,205,60,320,671,47.7,351,425,128,297,270,893,853,13,38,38.0,603,374,255,249,99,249,495,50.3,246,347,87,260,242,845,727,10,2022-2023
Celta Vigo,26,38.0,664,413,319,269,76,295,676,43.6,381,393,84,309,368,1032,666,5,26,38.0,593,356,314,204,75,295,618,47.7,323,369,121,248,394,987,681,9,2022-2023
Elche,32,38.0,633,363,367,212,54,280,603,46.4,323,413,131,282,323,956,766,13,32,38.0,656,402,293,265,98,311,653,47.6,342,418,97,321,288,944,698,9,2022-2023
Espanyol,33,38.0,652,379,330,239,83,301,600,50.2,299,416,134,282,338,990,788,9,33,38.0,505,326,239,220,46,260,517,50.3,257,328,100,228,238,743,822,10,2022-2023
Getafe,25,38.0,541,339,282,199,60,285,619,46.0,334,404,113,291,320,861,794,10,25,38.0,457,290,211,190,56,189,406,46.6,217,378,95,283,300,757,723,14,2022-2023
Girona,29,38.0,551,321,271,213,67,244,532,45.9,288,379,111,268,266,817,662,20,29,38.0,641,415,289,265,87,311,652,47.7,341,359,78,281,304,945,659,10,2022-2023
Mallorca,31,38.0,583,344,318,213,52,283,581,48.7,298,402,146,256,318,901,859,7,31,38.0,500,296,202,217,81,198,491,40.3,293,333,82,251,231,731,621,8,2022-2023
Osasuna,26,38.0,534,328,256,196,82,266,588,45.2,322,392,97,295,315,849,749,10,26,38.0,563,332,318,195,50,247,560,44.1,313,381,93,288,311,874,797,7,2022-2023
Rayo Vallecano,28,38.0,636,393,262,276,98,281,664,42.3,383,428,92,336,309,945,680,11,28,38.0,664,391,317,278,69,290,586,49.5,296,416,133,283,345,1009,810,10,2022-2023
Real Madrid,26,38.0,542,353,242,212,88,259,565,45.8,306,365,105,260,296,838,469,5,26,38.0,676,407,377,218,81,379,854,44.4,475,492,175,317,331,1007,678,8,2022-2023
Real Sociedad,30,38.0,660,395,304,254,102,285,613,46.5,328,399,103,296,271,931,624,13,30,38.0,661,403,341,237,83,293,600,48.8,307,402,110,292,325,986,613,15,2022-2023
Sevilla,35,38.0,587,367,261,230,96,281,591,47.5,310,361,127,234,339,926,633,9,35,38.0,569,353,273,206,90,257,526,48.9,269,358,96,262,271,840,769,13,2022-2023
Valencia,28,38.0,678,428,340,254,84,311,645,48.2,334,370,75,295,288,966,643,21,28,38.0,645,382,354,219,72,307,659,46.6,352,418,133,285,294,939,834,15,2022-2023
Valladolid,36,38.0,671,396,334,251,86,296,628,47.1,332,432,149,283,345,1016,767,8,36,38.0,634,389,309,232,93,318,627,50.7,309,409,97,312,264,898,662,5,2022-2023
Villarreal,32,38.0,578,370,276,201,101,270,534,50.6,264,372,125,247,262,840,691,16,32,38.0,688,423,349,240,99,345,780,44.2,435,426,114,312,349,1037,618,16,2022-2023
Alavés,33,38.0,550,324,271,221,58,262,637,41.1,375,373,106,267,376,926,890,7,33,38.0,511,273,249,193,69,233,504,46.2,271,351,87,264,311,822,729,12,2021-2022
Athletic Club,26,38.0,508,292,217,216,75,224,582,38.5,358,411,128,283,339,847,788,8,26,38.0,573,353,293,224,56,232,529,43.9,297,393,131,262,387,960,817,14,2021-2022
Atlético Madrid,26,38.0,636,346,290,279,67,293,619,47.3,326,372,98,274,365,1001,649,14,26,38.0,570,309,297,201,72,217,600,36.2,383,364,103,261,404,974,803,10,2021-2022
Barcelona,38,38.0,587,331,236,270,81,244,493,49.5,249,346,85,261,325,912,467,17,38,38.0,631,352,309,250,72,273,747,36.5,474,376,109,267,392,1023,809,10,2021-2022
Betis,31,38.0,662,392,322,261,79,324,695,46.6,371,386,112,274,361,1023,777,11,31,38.0,647,370,331,254,62,282,654,43.1,372,416,135,281,375,1022,614,11,2021-2022
Cádiz,33,38.0,647,380,346,238,63,301,711,42.3,410,390,106,284,413,1060,768,5,33,38.0,529,312,265,197,67,238,519,45.9,281,328,89,239,323,852,792,12,2021-2022
Celta Vigo,25,38.0,696,409,324,279,93,286,762,37.5,476,423,91,332,376,1072,634,11,25,38.0,554,324,236,237,81,244,590,41.4,346,410,97,313,454,1008,776,14,2021-2022
Elche,28,38.0,589,325,335,191,63,268,622,43.1,354,367,126,241,305,894,769,14,28,38.0,588,346,244,268,76,258,597,43.2,339,363,87,276,359,947,617,9,2021-2022
Espanyol,34,38.0,557,338,308,196,53,275,646,42.6,371,360,114,246,326,883,892,20,34,38.0,574,350,248,249,77,243,616,39.4,373,338,98,240,287,861,591,4,2021-2022
Getafe,31,38.0,587,360,266,243,78,248,594,41.8,346,400,96,304,401,988,719,8,31,38.0,511,279,204,239,68,210,452,46.5,242,343,106,237,357,868,668,8,2021-2022
Granada,32,38.0,611,343,310,240,61,274,632,43.4,358,437,130,307,326,937,841,8,32,38.0,546,280,268,193,85,225,495,45.5,270,359,106,253,307,853,662,11,2021-2022
Levante,31,38.0,558,305,268,212,78,237,611,38.8,374,326,110,216,377,935,735,12,31,38.0,637,384,345,238,54,335,683,49.0,348,379,107,272,327,964,621,17,2021-2022
Mallorca,33,38.0,607,332,301,235,71,248,551,45.0,303,374,119,255,344,951,826,9,33,38.0,648,351,257,304,87,244,612,39.9,368,377,121,256,306,954,746,10,2021-2022
Osasuna,29,38.0,577,331,270,236,71,251,598,42.0,347,340,115,225,368,945,758,5,29,38.0,515,326,265,204,46,206,467,44.1,261,355,99,256,353,868,843,15,2021-2022
Rayo Vallecano,28,38.0,621,359,320,237,64,280,688,40.7,408,410,95,315,365,986,686,9,28,38.0,653,391,304,274,75,282,639,44.1,357,400,130,270,343,996,711,15,2021-2022
Real Madrid,31,38.0,560,345,281,195,84,211,502,42.0,291,379,114,265,334,894,526,17,31,38.0,601,346,347,159,95,324,780,41.5,456,443,161,282,342,943,696,16,2021-2022
Real Sociedad,32,38.0,586,339,271,234,81,260,546,47.6,286,382,105,277,348,934,703,6,32,38.0,701,415,344,276,81,310,670,46.3,360,424,117,307,339,1040,693,9,2021-2022
Sevilla,33,38.0,534,302,252,211,71,236,542,43.5,306,367,124,243,270,804,603,18,33,38.0,609,353,312,203,94,283,588,48.1,305,344,91,253,348,957,748,8,2021-2022
Valencia,34,38.0,591,364,289,217,85,266,623,42.7,357,373,93,280,339,930,746,8,34,38.0,576,335,299,211,66,282,642,43.9,360,314,90,224,286,862,795,7,2021-2022
Villarreal,29,38.0,538,312,250,197,91,229,476,48.1,247,330,109,221,329,867,644,16,29,38.0,628,380,310,234,84,296,746,39.7,450,469,112,357,387,1015,690,11,2021-2022
Alavés,30,38.0,499,292,263,181,55,197,565,34.9,368,341,90,251,428,927,766,8,30,38.0,469,278,197,215,57,213,468,45.5,255,309,89,220,342,811,623,13,2020-2021
Athletic Club,27,38.0,461,269,194,200,67,167,515,32.4,348,341,74,267,344,805,684,9,27,38.0,532,303,265,226,41,197,501,39.3,304,396,94,302,484,1016,772,6,2020-2021
Atlético Madrid,25,38.0,622,367,291,253,78,296,631,46.9,335,361,83,278,386,1008,671,7,25,38.0,556,315,308,185,63,214,588,36.4,374,359,88,271,454,1010,674,9,2020-2021
Barcelona,25,38.0,499,293,223,195,81,224,522,42.9,298,325,70,255,361,860,429,16,25,38.0,598,320,357,181,60,257,770,33.4,513,440,133,307,517,1115,639,8,2020-2021
Betis,25,38.0,556,314,274,220,62,211,556,37.9,345,361,74,287,452,1008,687,11,25,38.0,586,336,286,245,55,218,638,34.2,420,408,130,278,364,950,610,12,2020-2021
Cádiz,34,38.0,573,317,305,216,52,247,607,40.7,360,368,99,269,437,1010,788,8,34,38.0,486,300,217,199,70,192,513,37.4,321,244,41,203,302,788,660,10,2020-2021
Celta Vigo,30,38.0,662,368,332,259,71,238,694,34.3,456,399,89,310,405,1067,751,12,30,38.0,468,288,183,204,81,189,465,40.6,276,344,76,268,489,957,522,6,2020-2021
Eibar,30,38.0,514,309,228,204,82,203,518,39.2,315,360,63,297,434,948,593,11,30,38.0,519,319,285,196,38,199,519,38.3,320,359,98,261,406,925,933,7,2020-2021
Elche,30,38.0,551,335,324,189,38,210,578,36.3,368,357,97,260,386,937,689,11,30,38.0,598,347,216,281,101,253,618,40.9,365,327,57,270,406,1004,586,8,2020-2021
Getafe,31,38.0,579,352,232,276,71,241,619,38.9,378,361,53,308,393,972,615,4,31,38.0,574,313,339,196,39,220,483,45.5,263,352,88,264,390,964,838,3,2020-2021
Granada,34,38.0,499,279,226,213,60,185,468,39.5,283,388,128,260,392,891,764,7,34,38.0,550,313,265,227,58,204,516,39.5,312,363,78,285,359,909,613,9,2020-2021
Huesca,27,38.0,556,322,309,191,56,239,579,41.3,340,342,83,259,437,993,616,7,27,38.0,532,309,212,221,99,227,653,34.8,426,325,80,245,323,855,773,14,2020-2021
Levante,29,38.0,512,283,268,189,55,208,543,38.3,335,336,94,242,432,944,680,15,29,38.0,575,334,287,204,84,249,615,40.5,366,374,76,298,433,1008,638,8,2020-2021
Osasuna,28,38.0,524,281,223,217,84,224,552,40.6,328,349,100,249,392,916,774,7,28,38.0,505,309,252,195,58,195,440,44.3,245,312,79,233,338,843,694,7,2020-2021
Real Madrid,30,38.0,531,318,266,188,77,192,532,36.1,340,344,83,261,398,929,544,12,30,38.0,531,295,277,184,70,216,645,33.5,429,418,133,285,380,911,707,16,2020-2021
Real Sociedad,30,38.0,547,322,240,227,80,200,480,41.7,280,353,96,257,315,862,563,5,30,38.0,531,311,253,212,66,220,550,40.0,330,413,104,309,379,910,710,16,2020-2021
Sevilla,26,38.0,492,297,220,200,72,184,510,36.1,326,310,90,220,362,854,636,10,26,38.0,516,306,255,196,65,207,599,34.6,392,325,87,238,407,923,635,13,2020-2021
Valencia,30,38.0,463,277,241,163,59,198,592,33.4,394,372,123,249,392,855,785,12,30,38.0,480,295,210,198,72,212,553,38.3,341,332,93,239,391,871,540,9,2020-2021
Valladolid,32,38.0,559,321,285,208,66,247,681,36.3,434,379,102,277,431,990,812,9,32,38.0,541,314,256,206,79,213,504,42.3,291,311,74,237,368,909,701,12,2020-2021
Villarreal,29,38.0,539,313,256,205,78,239,588,40.6,349,358,101,257,371,910,638,17,29,38.0,591,324,280,223,88,255,692,36.8,437,394,94,300,416,1007,617,12,2020-2021
Alavés,32,38.0,579,346,261,265,53,255,619,41.2,364,385,114,271,392,971,766,7,32,38.0,555,347,228,258,69,246,497,49.5,251,291,66,225,329,884,584,10,2019-2020
Athletic Club,26,38.0,533,324,262,204,67,217,613,35.4,396,339,92,247,373,906,755,7,26,38.0,549,313,270,222,57,250,587,42.6,337,330,85,245,327,876,704,15,2019-2020
Atlético Madrid,30,38.0,658,406,293,272,93,283,640,44.2,357,380,108,272,412,1070,729,18,30,38.0,572,355,292,224,56,195,543,35.9,348,342,112,230,384,956,709,12,2019-2020
Barcelona,28,38.0,536,323,216,223,97,211,501,42.1,290,313,87,226,342,878,529,16,28,38.0,623,361,351,202,70,269,793,33.9,524,430,117,313,525,1148,575,12,2019-2020
Betis,27,38.0,501,299,276,173,52,221,511,43.2,290,336,119,217,302,803,682,8,27,38.0,623,374,301,251,71,268,713,37.6,445,369,108,261,364,987,644,13,2019-2020
Celta Vigo,30,38.0,589,357,344,193,52,251,615,40.8,364,345,89,256,396,985,807,12,30,38.0,615,348,253,275,87,240,610,39.3,370,401,88,313,384,999,646,14,2019-2020
Eibar,26,38.0,567,338,240,228,99,264,607,43.5,343,332,81,251,430,997,692,8,26,38.0,553,331,293,218,42,198,458,43.2,260,328,97,231,342,895,923,17,2019-2020
Espanyol,31,38.0,628,364,303,253,72,257,701,36.7,444,380,96,284,360,988,731,17,31,38.0,539,305,265,217,57,208,489,42.5,281,319,107,212,367,906,787,9,2019-2020
Getafe,30,38.0,580,341,235,263,82,235,573,41.0,338,374,60,314,367,947,625,12,30,38.0,520,292,307,174,39,202,476,42.4,274,384,100,284,384,904,852,13,2019-2020
Granada,27,38.0,584,349,257,257,70,238,570,41.8,332,375,118,257,383,967,750,10,27,38.0,543,302,267,206,70,253,553,45.8,300,335,99,236,333,876,665,13,2019-2020
Leganés,29,38.0,603,357,317,215,71,254,610,41.6,356,320,73,247,418,1021,687,7,29,38.0,530,339,260,214,56,239,581,41.1,342,324,100,224,332,862,850,6,2019-2020
Levante,29,38.0,507,288,281,173,53,204,532,38.3,328,317,107,210,331,838,763,14,29,38.0,553,349,242,226,85,251,637,39.4,386,385,112,273,321,874,662,7,2019-2020
Mallorca,32,38.0,545,338,280,213,52,227,602,37.7,375,360,117,243,376,921,672,9,32,38.0,670,393,315,277,78,317,709,44.7,392,352,94,258,383,1053,690,8,2019-2020
Osasuna,31,38.0,613,361,275,267,71,267,617,43.3,350,385,98,287,417,1030,738,19,31,38.0,516,316,234,218,64,210,525,40.0,315,345,91,254,406,922,776,18,2019-2020
Real Madrid,26,38.0,586,355,252,253,81,226,595,38.0,369,367,77,290,381,967,590,13,26,38.0,600,352,302,216,82,285,769,37.1,484,367,101,266,374,974,777,14,2019-2020
Real Sociedad,27,38.0,551,321,254,224,73,252,573,44.0,321,346,79,267,320,871,694,12,27,38.0,591,359,268,260,63,234,589,39.7,355,421,108,313,409,1000,708,9,2019-2020
Sevilla,26,38.0,587,344,274,246,67,261,661,39.5,400,331,94,237,346,933,704,10,26,38.0,606,380,304,226,76,254,667,38.1,413,385,109,276,430,1036,810,15,2019-2020
Valencia,28,38.0,500,311,270,173,57,232,589,39.4,357,334,130,204,360,860,748,12,28,38.0,486,288,207,201,78,203,548,37.0,345,274,74,200,372,858,634,11,2019-2020
Valladolid,30,38.0,568,327,316,204,48,239,672,35.6,433,391,112,279,390,958,749,13,30,38.0,555,331,240,224,91,231,569,40.6,338,337,93,244,300,855,613,11,2019-2020
Villarreal,25,38.0,553,323,250,239,64,218,602,36.2,384,362,116,246,339,892,814,12,25,38.0,569,337,257,229,83,259,690,37.5,431,353,106,247,369,938,616,9,2019-2020
Alavés,26,38.0,646,389,352,228,66,254,595,42.7,341,419,117,302,390,1036,1066,13,26,38.0,554,330,259,240,55,213,489,43.6,276,363,91,272,364,918,859,10,2018-2019
Athletic Club,27,38.0,643,384,311,245,87,245,646,37.9,401,414,93,321,453,1096,815,7,27,38.0,598,402,290,234,74,254,542,46.9,288,375,81,294,355,953,868,8,2018-2019
Atlético Madrid,29,38.0,784,487,402,298,84,319,700,45.6,381,374,94,280,463,1247,837,12,29,38.0,617,383,331,212,74,205,571,35.9,366,394,100,294,436,1053,817,9,2018-2019
Barcelona,30,38.0,537,346,218,232,87,226,492,45.9,266,360,101,259,391,928,565,16,30,38.0,742,435,426,252,64,307,753,40.8,446,438,106,332,545,1287,689,23,2018-2019
Betis,25,38.0,615,378,309,227,79,219,544,40.3,325,382,80,302,361,976,702,21,25,38.0,659,392,318,258,83,267,716,37.3,449,421,114,307,424,1083,757,16,2018-2019
Celta Vigo,28,38.0,634,377,364,213,57,258,562,45.9,304,380,105,275,382,1016,889,19,28,38.0,617,379,290,250,77,246,626,39.3,380,386,120,266,361,978,727,13,2018-2019
Eibar,25,38.0,637,424,238,289,110,240,563,42.6,323,357,53,304,368,1005,683,10,25,38.0,635,393,387,197,51,248,592,41.9,344,453,98,355,474,1109,1263,15,2018-2019
Espanyol,25,38.0,655,394,324,244,87,263,684,38.5,421,402,134,268,408,1063,950,14,25,38.0,578,382,275,208,95,204,522,39.1,318,441,113,328,420,998,690,17,2018-2019
Getafe,26,38.0,604,358,246,281,77,255,617,41.3,362,422,81,341,453,1057,888,15,26,38.0,643,389,336,240,67,277,576,48.1,299,416,97,319,342,985,878,14,2018-2019
Girona,26,38.0,613,367,309,247,57,264,636,41.5,372,401,124,277,432,1045,928,14,26,38.0,591,366,304,234,53,221,537,41.2,316,311,75,236,407,998,858,17,2018-2019
Huesca,30,38.0,712,452,363,290,59,303,694,43.7,391,414,107,307,440,1152,953,12,30,38.0,634,399,291,272,71,278,592,47.0,314,383,102,281,374,1008,913,9,2018-2019
Leganés,29,38.0,609,382,325,221,63,227,581,39.1,354,329,84,245,432,1041,907,10,29,38.0,520,342,255,198,67,216,469,46.1,253,319,78,241,351,871,916,11,2018-2019
Levante,26,38.0,572,372,308,196,68,264,722,36.6,458,455,151,304,422,994,842,12,26,38.0,765,480,367,296,102,336,738,45.5,402,397,106,291,397,1162,825,12,2018-2019
Rayo Vallecano,29,38.0,651,422,369,223,59,257,592,43.4,335,388,77,311,433,1084,931,16,29,38.0,809,491,335,354,120,314,848,37.0,534,380,120,260,371,1180,768,15,2018-2019
Real Madrid,27,38.0,626,395,267,253,106,245,629,39.0,384,374,78,296,373,999,602,11,27,38.0,651,397,334,243,74,295,755,39.1,460,465,148,317,449,1100,856,18,2018-2019
Real Sociedad,30,38.0,579,344,299,219,61,248,584,42.5,336,444,109,335,425,1004,842,19,30,38.0,733,478,349,290,94,267,678,39.4,411,406,89,317,390,1123,721,11,2018-2019
Sevilla,27,38.0,598,408,288,237,73,203,513,39.6,310,370,114,256,365,963,817,15,27,38.0,640,396,297,245,98,249,606,41.1,357,455,128,327,444,1084,994,15,2018-2019
Valencia,25,38.0,598,384,299,228,71,238,588,40.5,350,447,120,327,418,1016,860,12,25,38.0,583,377,270,247,66,246,589,41.8,343,387,95,292,448,1031,818,16,2018-2019
Valladolid,28,38.0,714,441,369,265,80,280,678,41.3,398,413,113,300,387,1101,874,16,28,38.0,530,347,260,216,54,183,477,38.4,294,358,87,271,395,925,825,12,2018-2019
Villarreal,26,38.0,667,413,333,255,79,273,659,41.4,386,406,142,264,390,1057,877,12,26,38.0,595,359,319,205,71,255,603,42.3,348,403,129,274,439,1034,786,15,2018-2019
Alavés,30,38.0,702,464,364,265,73,267,663,40.3,396,407,133,274,498,1200,981,11,30,38.0,650,462,323,246,81,246,576,42.7,330,317,88,229,422,1072,721,5,2017-2018
Athletic Club,26,38.0,739,486,359,304,76,296,735,40.3,439,432,103,329,465,1204,820,9,26,38.0,670,449,332,280,58,261,611,42.7,350,374,76,298,422,1092,919,6,2017-2018
Atlético Madrid,26,38.0,917,614,442,372,103,377,847,44.5,470,462,129,333,513,1430,885,4,26,38.0,715,494,346,273,96,267,693,38.5,426,390,91,299,488,1203,792,12,2017-2018
Barcelona,25,38.0,629,413,281,262,86,229,552,41.5,323,366,103,263,424,1053,525,10,25,38.0,819,517,438,307,74,354,973,36.4,619,477,128,349,618,1437,694,14,2017-2018
Betis,29,38.0,635,424,319,252,64,213,537,39.7,324,356,95,261,427,1062,869,17,29,38.0,622,405,296,261,65,240,679,35.3,439,356,94,262,448,1070,566,8,2017-2018
Celta Vigo,23,38.0,589,420,304,232,53,218,556,39.2,338,327,101,226,497,1086,780,10,23,38.0,655,426,296,288,71,227,603,37.6,376,372,103,269,495,1150,735,13,2017-2018
Eibar,27,38.0,643,436,271,282,90,258,613,42.1,355,349,53,296,554,1197,712,9,27,38.0,671,435,402,231,38,297,649,45.8,352,401,115,286,510,1181,1156,4,2017-2018
Espanyol,25,38.0,716,500,357,278,81,271,700,38.7,429,362,116,246,515,1231,902,9,25,38.0,661,443,318,275,68,273,596,45.8,323,404,95,309,433,1094,846,9,2017-2018
Getafe,32,38.0,715,491,369,267,79,276,732,37.7,456,350,69,281,487,1202,899,5,32,38.0,696,480,350,273,73,288,584,49.3,296,357,83,274,515,1211,788,14,2017-2018
Girona,25,38.0,611,403,299,254,58,240,606,39.6,366,329,84,245,490,1101,858,6,25,38.0,653,439,318,268,67,284,644,44.1,360,308,96,212,396,1049,896,16,2017-2018
La Coruña,32,38.0,728,500,386,282,60,292,679,43.0,387,391,113,278,484,1212,942,13,32,38.0,624,431,306,263,55,245,620,39.5,375,356,102,254,491,1115,825,8,2017-2018
Las Palmas,36,38.0,654,433,325,269,60,268,647,41.4,379,367,112,255,508,1162,713,21,36,38.0,722,514,306,331,85,264,713,37.0,449,355,90,265,506,1228,785,5,2017-2018
Leganés,28,38.0,721,483,350,307,64,323,697,46.3,374,361,87,274,583,1304,777,9,28,38.0,720,474,356,284,80,267,608,43.9,341,371,85,286,432,1152,796,7,2017-2018
Levante,33,38.0,616,414,328,222,66,239,625,38.2,386,395,127,268,477,1093,811,9,33,38.0,755,522,380,282,93,310,685,45.3,375,380,105,275,454,1209,813,7,2017-2018
Málaga,37,38.0,745,509,383,276,86,272,707,38.5,435,362,101,261,497,1242,890,3,37,38.0,748,509,347,315,86,278,586,47.4,308,359,88,271,452,1200,941,8,2017-2018
Real Madrid,24,38.0,687,470,317,275,95,252,621,40.6,369,362,83,279,424,1111,536,16,24,38.0,644,418,358,205,81,251,752,33.4,501,431,152,279,486,1130,974,17,2017-2018
Real Sociedad,27,38.0,547,374,249,228,70,227,536,42.4,309,367,91,276,446,993,665,6,27,38.0,708,510,366,266,76,261,623,41.9,362,430,127,303,489,1197,855,13,2017-2018
Sevilla,31,38.0,768,535,354,325,89,296,685,43.2,389,419,114,305,409,1177,849,17,31,38.0,699,471,353,277,69,269,661,40.7,392,442,118,324,467,1166,851,12,2017-2018
Valencia,25,38.0,745,492,407,267,71,309,692,44.7,383,416,108,308,459,1204,910,9,25,38.0,746,488,335,312,99,271,699,38.8,428,364,108,256,542,1288,698,13,2017-2018
Villarreal,32,38.0,711,466,356,278,77,277,700,39.6,423,447,131,316,427,1138,1023,7,32,38.0,640,440,294,260,86,247,575,43.0,328,383,109,274,518,1158,696,9,2017-2018
Athletic Club,26,30.0,446,318,220,154,72,133,307,43.3,174,338,78,260,249,695,608,4,26,30.0,586,432,270,223,93,236,405,58.3,169,314,71,243,301,887,554,6,2024-2025-femenino
Atlético Madrid,23,30.0,463,329,221,175,67,145,279,52.0,134,340,87,253,287,750,502,5,23,30.0,587,416,309,210,68,218,407,53.6,189,311,76,235,330,917,664,2,2024-2025-femenino
Barcelona,26,30.0,434,330,94,186,154,150,240,62.5,90,241,25,216,217,651,140,8,26,30.0,526,359,396,97,33,234,487,48.0,253,488,230,258,375,901,1024,7,2024-2025-femenino
Dep La Coruña,27,30.0,507,365,292,163,52,184,398,46.2,214,347,99,248,300,807,832,4,27,30.0,503,368,203,206,94,188,423,44.4,235,285,56,229,282,785,391,3,2024-2025-femenino
Eibar,26,30.0,518,363,280,166,72,223,444,50.2,221,385,93,292,322,840,812,2,26,30.0,466,337,237,171,58,150,302,49.7,152,267,49,218,205,671,439,4,2024-2025-femenino
Espanyol,26,30.0,589,428,288,221,80,196,429,45.7,233,375,97,278,376,965,687,5,26,30.0,492,370,241,172,79,177,328,54.0,151,279,46,233,218,710,547,9,2024-2025-femenino
Granada,24,30.0,547,387,258,204,85,233,439,53.1,206,283,71,212,313,860,477,7,24,30.0,482,341,241,168,73,183,380,48.2,197,333,91,242,271,753,653,6,2024-2025-femenino
Levante,25,30.0,607,432,345,187,75,271,499,54.3,228,374,97,277,310,917,613,6,25,30.0,543,392,254,202,87,192,408,47.1,216,349,58,291,345,888,545,6,2024-2025-femenino
Levante Planas,27,30.0,503,350,204,196,103,187,369,50.7,182,298,55,243,284,787,525,3,27,30.0,639,471,328,230,81,214,455,47.0,241,339,83,256,339,978,594,5,2024-2025-femenino
Madrid CFF,26,30.0,529,388,292,190,47,198,374,52.9,176,324,91,233,315,844,625,4,26,30.0,434,300,179,178,77,151,297,50.8,146,355,74,281,341,775,559,4,2024-2025-femenino
Real Betis,26,30.0,575,418,277,220,78,220,446,49.3,226,360,114,246,267,842,615,14,26,30.0,602,440,207,272,123,214,391,54.7,177,339,55,284,337,939,461,5,2024-2025-femenino
Real Madrid,30,30.0,455,336,170,190,95,154,286,53.8,132,249,45,204,311,766,369,7,30,30.0,566,369,336,165,65,234,539,43.4,305,384,141,243,297,863,784,10,2024-2025-femenino
Real Sociedad,26,30.0,575,393,253,228,94,209,412,50.7,203,297,58,239,236,811,486,7,26,30.0,555,418,281,215,59,161,336,47.9,175,358,76,282,359,914,584,7,2024-2025-femenino
Sevilla,22,30.0,549,408,287,214,48,190,432,44.0,242,326,78,248,365,914,685,5,22,30.0,517,379,220,203,94,199,385,51.7,186,280,51,229,292,809,442,7,2024-2025-femenino
UDG Tenerife,28,30.0,502,370,258,185,59,164,354,46.3,190,362,106,256,332,834,692,5,28,30.0,507,375,238,212,57,183,362,50.6,179,257,53,204,244,751,643,2,2024-2025-femenino
Valencia,30,30.0,668,477,385,221,62,248,511,48.5,263,333,71,262,347,1015,678,3,30,30.0,462,325,184,176,102,171,314,54.5,143,294,55,239,295,757,462,6,2024-2025-femenino
