Season,Squad,Unnamed: 3_level_0 Poss_for,Performance Gls_for,Performance Ast_for,Performance G+A_for,Performance G-PK_for,Performance PK_for,Performance PKatt_for,Performance CrdY_for,Performance CrdR_for,Expected xG_for,Expected npxG_for,Expected xAG_for,Expected npxG+xAG_for,Progression PrgC_for,Progression PrgP_for,Unnamed: 3_level_0 Poss_against,Performance Gls_against,Performance Ast_against,Performance G+A_against,Performance G-PK_against,Performance PK_against,Performance PKatt_against,Performance CrdY_against,Performance CrdR_against,Expected xG_against,Expected npxG_against,Expected xAG_against,Expected npxG+xAG_against,Progression PrgC_against,Progression PrgP_against
2024-2025 Premier League,Arsenal,56.9,67,55,122,65,2,2,70,6,59.9,58.4,45.3,103.6,852,1826,43.1,34,24,58,31,3,3,83,2,34.4,32.0,24.5,56.6,618,938
2024-2025 Premier League,Aston Villa,50.5,56,45,101,53,3,6,76,4,56.1,51.3,41.7,93.0,720,1344,49.5,51,36,87,49,2,3,104,2,50.1,47.8,36.4,84.2,688,1315
2024-2025 Premier League,Bournemouth,48.5,57,41,98,51,6,7,97,3,64.0,58.5,43.8,102.3,754,1489,51.5,46,36,82,42,4,4,94,5,48.5,45.3,36.5,81.8,685,1295
2024-2025 Premier League,Brentford,47.9,65,44,109,60,5,6,62,1,59.0,54.4,42.4,96.8,598,1356,52.1,54,42,96,53,1,1,82,3,55.4,54.7,43.3,97.9,835,1562
2024-2025 Premier League,Brighton,52.3,64,41,105,57,7,7,78,3,58.7,53.3,40.4,93.7,816,1539,47.7,57,39,96,48,9,9,93,5,54.6,47.7,41.3,88.9,607,1209
2024-2025 Premier League,Chelsea,57.1,61,47,108,57,4,5,101,2,67.8,63.8,52.7,116.5,861,1595,42.9,43,33,76,38,5,6,98,2,47.3,42.6,35.3,77.8,600,1206
2024-2025 Premier League,Crystal Palace,42.8,49,38,87,46,3,4,80,4,60.4,57.3,46.4,103.7,510,1158,57.2,48,39,87,47,1,2,84,4,49.1,47.5,38.5,86.0,686,1578
2024-2025 Premier League,Everton,40.9,39,27,66,37,2,2,82,2,41.8,40.2,32.2,72.4,486,1041,59.1,44,35,79,44,0,2,46,2,46.2,44.6,34.6,79.2,724,1627
2024-2025 Premier League,Fulham,52.3,53,44,97,50,3,4,80,2,49.0,45.9,37.5,83.4,786,1558,47.7,52,40,92,49,3,4,67,3,47.2,44.1,34.4,78.5,654,1396
2024-2025 Premier League,Ipswich Town,40.6,35,26,61,33,2,2,93,5,34.4,32.8,24.2,57.0,513,935,59.4,80,55,135,74,6,6,65,2,72.7,68.3,53.5,121.8,812,1726
2024-2025 Premier League,Leicester City,45.4,33,25,58,31,2,3,87,0,32.6,30.4,25.1,55.5,576,1082,54.6,77,57,134,74,3,4,58,2,71.9,68.8,52.2,121.0,735,1755
2024-2025 Premier League,Liverpool,57.7,85,65,150,76,9,9,67,3,82.2,75.2,61.6,136.8,825,1924,42.3,39,28,67,38,1,2,84,2,38.6,36.9,29.4,66.2,683,1091
2024-2025 Premier League,Manchester City,61.3,71,51,122,68,3,4,59,2,68.1,64.9,54.2,119.1,1146,1944,38.7,42,32,74,38,4,4,88,2,47.7,44.6,37.2,81.7,546,912
2024-2025 Premier League,Manchester Utd,53.5,42,29,71,38,4,4,86,3,52.6,49.4,39.7,89.1,697,1448,46.5,52,36,88,49,3,4,71,3,53.8,50.8,38.4,89.2,672,1184
2024-2025 Premier League,Newcastle Utd,51.3,66,50,116,61,5,6,68,1,63.8,59.5,46.0,105.5,759,1595,48.7,45,41,86,44,1,2,97,3,45.5,44.0,35.9,79.9,667,1273
2024-2025 Premier League,Nott'ham Forest,41.2,57,42,99,54,3,3,90,2,45.5,43.2,33.0,76.2,633,1125,58.8,46,35,81,43,3,3,104,2,48.9,46.5,35.2,81.7,966,1886
2024-2025 Premier League,Southampton,48.5,25,16,41,25,0,2,89,3,32.7,30.9,24.8,55.8,640,1127,51.5,86,61,147,79,7,9,54,1,84.8,77.9,63.0,140.9,814,1647
2024-2025 Premier League,Tottenham,54.7,61,47,108,58,3,4,72,1,58.8,55.7,44.4,100.1,840,1593,45.3,61,43,104,58,3,3,85,3,63.3,60.9,46.3,107.2,660,1330
2024-2025 Premier League,West Ham,48.4,43,29,72,40,3,3,82,3,47.0,44.7,33.9,78.6,632,1222,51.6,59,45,104,56,3,3,56,1,59.7,57.4,47.6,105.0,832,1622
2024-2025 Premier League,Wolves,48.1,53,42,95,53,0,0,79,2,43.7,43.7,35.4,79.1,607,1185,51.9,66,47,113,59,7,9,85,3,58.1,51.0,41.5,92.5,767,1534
2024-2025 Serie A,Atalanta,55.3,76,54,130,71,5,7,67,1,65.0,59.5,46.9,106.4,897,1824,44.7,35,26,61,33,2,2,51,2,38.6,37.1,27.5,64.6,510,988
2024-2025 Serie A,Bologna,58.1,56,43,99,50,6,7,61,4,49.3,43.8,35.2,79.0,639,1468,41.9,45,32,77,43,2,3,95,3,36.7,34.3,25.4,59.7,440,876
2024-2025 Serie A,Cagliari,44.9,38,31,69,35,3,3,68,3,42.7,40.3,32.0,72.4,506,1150,55.1,56,40,96,50,6,6,61,5,55.3,51.1,40.2,91.3,756,1504
2024-2025 Serie A,Como,54.6,44,39,83,44,0,2,87,7,45.4,43.9,36.6,80.5,658,1377,45.4,52,35,87,45,7,7,95,5,43.0,37.6,28.9,66.5,539,1116
2024-2025 Serie A,Empoli,41.7,31,21,52,29,2,3,68,5,32.5,30.1,22.9,53.1,428,1013,58.3,58,48,106,57,1,3,58,3,50.1,47.7,37.2,84.9,588,1402
2024-2025 Serie A,Fiorentina,51.0,55,37,92,49,6,8,81,3,48.9,42.6,35.1,77.7,620,1240,49.0,40,29,69,39,1,3,92,7,42.8,40.4,30.5,70.9,675,1277
2024-2025 Serie A,Genoa,45.6,35,27,62,35,0,2,71,1,37.2,35.5,26.8,62.3,470,980,54.4,46,31,77,40,6,8,75,2,47.2,41.1,33.9,75.0,609,1375
2024-2025 Serie A,Hellas Verona,38.7,31,20,51,29,2,2,98,9,33.8,32.3,24.8,57.1,449,1011,61.3,65,48,113,63,2,4,53,2,53.4,50.3,39.1,89.5,665,1593
2024-2025 Serie A,Inter,59.4,76,57,133,68,8,9,56,1,66.9,60.1,48.3,108.5,694,1730,40.6,31,20,51,28,3,4,51,4,36.4,33.1,25.5,58.6,631,1064
2024-2025 Serie A,Juventus,57.2,56,40,96,50,6,6,67,3,51.0,46.3,35.9,82.2,810,1561,42.8,35,22,57,30,5,5,73,2,34.0,30.1,21.4,51.5,540,1097
2024-2025 Serie A,Lazio,55.1,60,43,103,54,6,7,93,7,57.2,52.0,38.5,90.4,774,1588,44.9,47,34,81,43,4,4,116,14,37.7,34.7,28.2,62.8,548,1133
2024-2025 Serie A,Lecce,43.8,27,21,48,24,3,4,61,7,34.6,31.8,24.5,56.3,519,1071,56.2,55,37,92,47,8,10,81,5,57.1,49.6,37.8,87.4,654,1685
2024-2025 Serie A,Milan,53.9,59,43,102,55,4,8,70,6,63.7,57.5,46.8,104.4,915,1589,46.1,40,35,75,39,1,2,75,3,41.3,39.7,33.5,73.2,618,1228
2024-2025 Serie A,Monza,48.5,27,18,45,24,3,3,90,3,29.9,27.7,20.9,48.6,533,1096,51.5,66,54,120,64,2,4,63,2,54.7,51.6,41.7,93.4,699,1599
2024-2025 Serie A,Napoli,54.6,56,42,98,52,4,5,47,0,52.9,49.1,39.1,88.2,739,1546,45.4,25,18,43,24,1,4,72,1,29.6,26.3,21.7,48.0,537,1142
2024-2025 Serie A,Parma,44.2,43,31,74,37,6,7,78,6,43.1,37.6,29.3,66.9,578,1059,55.8,56,42,98,51,5,5,80,3,56.4,52.6,41.7,94.3,822,1761
2024-2025 Serie A,Roma,53.9,55,35,90,47,8,8,66,1,53.0,46.7,35.0,81.7,691,1501,46.1,34,21,55,30,4,4,87,6,40.9,37.7,26.7,64.4,668,1278
2024-2025 Serie A,Torino,47.5,36,21,57,34,2,4,80,3,34.6,31.6,22.5,54.0,529,1113,52.5,43,30,73,40,3,7,63,1,50.4,44.9,34.7,79.7,722,1346
2024-2025 Serie A,Udinese,47.2,41,28,69,39,2,4,88,5,38.2,35.0,27.2,62.1,566,1160,52.8,51,30,81,44,7,8,61,5,52.6,46.5,35.6,82.1,582,1282
2024-2025 Serie A,Venezia,45.1,31,16,47,27,4,5,75,2,35.8,32.0,22.2,54.2,507,1066,54.9,53,35,88,43,10,11,70,2,57.5,48.9,39.3,88.2,719,1397
2024-2025 Ligue 1,Angers,41.2,31,17,48,26,5,6,49,2,36.0,31.3,23.5,54.7,502,953,58.8,53,40,93,49,4,5,79,7,57.8,53.9,42.2,96.0,784,1776
2024-2025 Ligue 1,Auxerre,42.5,47,35,82,43,4,5,68,4,41.0,37.3,32.0,69.3,484,1084,57.5,48,36,84,42,6,8,50,4,58.6,52.3,43.9,96.3,645,1522
2024-2025 Ligue 1,Brest,48.4,52,32,84,45,7,9,69,3,45.4,38.3,29.4,67.8,470,1096,51.6,57,39,96,49,8,10,63,2,57.4,50.0,38.5,88.5,559,1521
2024-2025 Ligue 1,Le Havre,43.1,37,21,58,28,9,10,56,4,41.4,33.4,24.4,57.8,538,1051,56.9,70,50,120,65,5,6,68,6,62.8,58.5,45.3,103.8,633,1639
2024-2025 Ligue 1,Lens,54.1,40,26,66,35,5,5,86,8,51.8,48.3,36.2,84.4,570,1451,45.9,39,25,64,31,8,9,62,2,45.3,38.3,29.7,68.0,585,1095
2024-2025 Ligue 1,Lille,57.6,52,29,81,45,7,10,77,2,54.7,47.5,35.1,82.6,669,1616,42.4,35,23,58,31,4,4,63,8,42.5,39.4,29.0,68.4,503,945
2024-2025 Ligue 1,Lyon,56.4,62,46,108,54,8,10,60,0,60.3,52.5,44.4,96.9,709,1615,43.6,46,32,78,43,3,3,71,3,45.7,43.3,33.0,76.4,624,1135
2024-2025 Ligue 1,Marseille,63.3,70,49,119,62,8,10,64,6,63.8,55.8,44.6,100.5,664,1714,36.7,45,35,80,42,3,6,61,3,45.2,40.9,31.5,72.4,436,872
2024-2025 Ligue 1,Monaco,55.0,63,49,112,57,6,7,60,4,72.8,67.7,55.3,123.0,670,1638,45.0,41,30,71,38,3,3,70,3,34.8,32.7,26.4,59.1,549,1218
2024-2025 Ligue 1,Montpellier,45.3,23,13,36,20,3,4,87,7,33.5,30.4,23.0,53.4,529,1039,54.7,76,58,134,68,8,9,70,2,63.3,56.1,44.1,100.2,632,1461
2024-2025 Ligue 1,Nantes,40.4,39,27,66,34,5,5,71,4,39.1,35.3,27.8,63.1,502,1053,59.6,49,33,82,42,7,8,55,5,55.5,49.3,39.3,88.7,715,1728
2024-2025 Ligue 1,Nice,47.5,62,43,105,56,6,6,59,5,61.6,56.9,42.9,99.8,701,1320,52.5,40,30,70,38,2,3,72,4,40.2,38.0,31.2,69.2,618,1314
2024-2025 Ligue 1,Paris S-G,68.0,89,69,158,83,6,7,37,0,88.9,83.3,70.8,154.1,936,2123,32.0,34,22,56,31,3,3,61,2,31.2,29.0,22.7,51.6,467,874
2024-2025 Ligue 1,Reims,44.1,32,19,51,31,1,2,66,6,37.4,35.9,26.5,62.3,586,1156,55.9,47,32,79,43,4,5,49,3,57.4,53.5,40.5,94.1,663,1636
2024-2025 Ligue 1,Rennes,50.9,51,32,83,46,5,8,67,2,48.6,42.7,29.6,72.4,663,1440,49.1,48,37,85,45,3,6,68,6,46.0,41.4,33.7,75.2,575,1144
2024-2025 Ligue 1,Saint-Ã‰tienne,47.1,39,28,67,36,3,4,65,3,36.4,33.2,24.6,57.8,529,1262,52.9,75,41,116,62,13,15,55,1,74.3,62.3,47.2,109.5,714,1467
2024-2025 Ligue 1,Strasbourg,50.1,54,43,97,52,2,2,71,3,49.3,47.7,38.5,86.2,563,1204,49.9,42,21,63,34,8,9,72,2,56.1,49.3,39.1,88.3,537,1361
2024-2025 Ligue 1,Toulouse,45.0,42,34,76,39,3,4,54,3,49.1,46.0,34.7,80.6,543,1219,55.0,40,28,68,39,1,2,77,3,36.8,35.2,26.0,61.2,589,1326
2024-2025 Bundesliga,Augsburg,44.3,35,26,61,34,1,2,78,5,34.7,33.1,25.1,58.2,450,1162,55.7,49,31,80,44,5,5,50,3,48.9,45.0,35.0,80.0,604,1438
2024-2025 Bundesliga,Bayern Munich,67.9,96,66,162,87,9,10,48,1,81.7,74.0,59.7,133.7,831,2138,32.1,32,25,57,31,1,2,65,2,25.5,24.0,18.1,42.1,286,669
2024-2025 Bundesliga,Bochum,45.5,32,23,55,31,1,3,71,2,41.8,39.3,30.0,69.4,378,1090,54.5,68,52,120,65,3,6,44,4,63.2,58.2,49.1,107.3,599,1447
2024-2025 Bundesliga,Dortmund,58.9,69,56,125,64,5,6,71,6,61.2,56.5,47.4,103.9,701,1563,41.1,50,39,89,46,4,4,65,5,42.8,39.6,30.9,70.5,473,1058
2024-2025 Bundesliga,Eint Frankfurt,49.7,68,47,115,65,3,5,55,1,65.1,61.4,45.2,106.6,585,1347,50.3,44,28,72,43,1,3,58,3,48.0,45.7,35.6,81.3,547,1289
2024-2025 Bundesliga,Freiburg,48.7,46,35,81,46,0,4,54,2,44.3,41.1,30.5,71.7,442,1129,51.3,52,39,91,50,2,4,59,2,42.4,39.4,30.7,70.1,471,1182
2024-2025 Bundesliga,Gladbach,49.6,53,39,92,49,4,5,53,3,50.6,46.6,37.7,84.3,530,1112,50.4,55,34,89,48,7,8,46,1,63.4,57.0,45.2,102.2,607,1520
2024-2025 Bundesliga,Heidenheim,43.5,37,26,63,32,5,5,66,1,40.3,36.3,28.6,64.9,516,974,56.5,64,50,114,58,6,6,78,2,57.6,53.0,43.1,96.1,643,1620
2024-2025 Bundesliga,Hoffenheim,48.7,46,30,76,43,3,3,66,2,42.6,40.3,32.7,73.0,481,1218,51.3,65,51,116,62,3,6,48,3,55.8,51.1,41.4,92.5,529,1347
2024-2025 Bundesliga,Holstein Kiel,43.6,49,29,78,45,4,5,77,4,39.8,35.9,26.7,62.6,359,875,56.4,77,52,129,71,6,7,74,2,61.0,55.6,44.5,100.1,549,1572
2024-2025 Bundesliga,Leverkusen,59.2,70,53,123,67,3,6,62,1,56.9,52.0,41.9,93.9,696,1692,40.8,39,25,64,35,4,4,68,1,36.2,33.1,22.8,55.9,403,984
2024-2025 Bundesliga,Mainz 05,50.4,53,37,90,49,4,4,71,5,50.1,47.0,37.5,84.6,466,1286,49.6,43,28,71,39,4,5,83,6,48.1,44.6,31.2,75.8,436,1123
2024-2025 Bundesliga,RB Leipzig,52.2,51,36,87,48,3,4,68,5,46.6,43.4,35.6,79.0,516,1353,47.8,48,35,83,46,2,3,73,1,53.3,51.0,38.8,89.8,530,1275
2024-2025 Bundesliga,St. Pauli,44.2,26,22,48,25,1,2,53,4,35.3,33.7,26.3,60.0,418,1073,55.8,40,30,70,39,1,5,75,1,45.4,41.5,35.0,76.4,484,1388
2024-2025 Bundesliga,Stuttgart,57.2,61,45,106,59,2,6,72,5,62.3,57.7,45.3,103.0,545,1493,42.8,52,34,86,50,2,3,96,7,46.9,44.5,33.8,78.3,443,1023
2024-2025 Bundesliga,Union Berlin,40.0,36,25,61,33,3,3,72,1,37.0,34.7,23.5,58.2,390,1049,60.0,49,36,85,47,2,6,57,2,47.8,43.0,32.4,75.4,595,1491
2024-2025 Bundesliga,Werder Bremen,50.0,53,38,91,50,3,5,75,4,49.1,45.7,37.4,83.1,495,1351,50.1,54,39,93,51,3,3,81,8,48.1,45.7,36.3,82.1,540,1336
2024-2025 Bundesliga,Wolfsburg,46.1,53,38,91,49,4,5,75,3,47.5,43.4,33.0,76.4,489,1205,53.9,53,43,96,51,2,3,67,2,52.5,50.1,40.5,90.6,549,1348
2024-2025,AlavÃ©s,45.3,38,20,58,29,9,11,107,5,42.8,34.1,25.4,59.5,449,1160,54.7,46,28,74,35,11,11,107,5,47.0,38.5,33.3,71.8,573,1323
2024-2025,Athletic Club,48.4,53,40,93,50,3,6,64,3,53.0,48.2,36.7,84.9,682,1579,51.6,28,11,39,25,3,5,83,4,37.8,33.9,22.9,56.7,468,1177
2024-2025,AtlÃ©tico Madrid,52.6,68,51,119,62,6,7,75,3,64.6,59.3,47.9,107.2,760,1559,47.4,28,17,45,23,5,5,68,0,33.4,29.5,23.9,53.4,581,1543
2024-2025,Barcelona,68.3,99,72,171,92,7,8,63,3,91.5,85.2,67.5,152.7,860,2212,31.7,39,31,70,35,4,4,89,2,41.9,38.8,32.6,71.4,406,780
2024-2025,Betis,52.4,55,37,92,48,7,10,75,4,54.7,46.9,37.5,84.5,679,1486,47.6,49,32,81,45,4,4,102,7,50.6,47.4,38.4,85.9,611,1411
2024-2025,Celta Vigo,53.6,58,40,98,50,8,9,84,6,54.2,47.3,38.4,85.7,709,1659,46.4,55,45,100,52,3,4,88,7,43.4,40.0,33.3,73.3,564,1222
2024-2025,Espanyol,39.8,38,27,65,33,5,5,88,1,34.4,30.5,24.5,55.0,497,1000,60.2,50,39,89,46,4,6,66,2,53.8,49.0,39.6,88.6,838,1821
2024-2025,Getafe,41.8,34,21,55,29,5,5,110,7,36.8,33.0,23.9,56.9,368,981,58.2,39,21,60,31,8,9,101,5,46.2,39.4,31.3,70.7,499,1284
2024-2025,Girona,56.3,43,31,74,39,4,5,76,2,42.5,38.6,31.6,70.2,765,1691,43.7,59,46,105,56,3,6,80,4,50.4,45.7,36.5,82.2,582,1183
2024-2025,Las Palmas,50.7,38,27,65,35,3,4,110,4,36.3,33.2,26.3,59.4,499,1210,49.3,58,43,101,53,5,10,90,7,66.8,59.3,47.5,106.8,684,1470
2024-2025,LeganÃ©s,42.6,38,27,65,33,5,7,82,6,36.0,30.6,23.3,53.8,417,1030,57.4,53,34,87,46,7,8,74,1,59.4,53.1,40.9,94.0,754,1675
2024-2025,Mallorca,46.8,34,24,58,30,4,5,81,6,38.8,34.9,26.5,61.3,479,1184,53.2,43,31,74,40,3,3,70,2,46.8,44.5,36.0,80.5,693,1587
2024-2025,Osasuna,46.1,46,28,74,37,9,9,88,0,44.0,37.8,29.8,67.6,567,1221,53.9,51,38,89,44,7,7,81,6,53.7,48.2,40.6,88.9,647,1546
2024-2025,Rayo Vallecano,51.7,38,27,65,38,0,1,96,3,45.4,44.6,36.2,80.9,589,1362,48.3,44,33,77,38,6,8,78,4,49.0,42.7,33.0,75.7,613,1326
2024-2025,Real Madrid,60.4,78,55,133,68,10,14,57,4,75.3,64.5,54.6,119.0,983,1967,39.6,37,27,64,34,3,3,89,6,42.8,40.8,32.0,72.8,648,1168
2024-2025,Real Sociedad,53.8,34,22,56,30,4,4,85,4,42.5,39.3,30.9,70.3,645,1341,46.2,46,32,78,41,5,7,82,0,43.9,38.3,29.0,67.3,538,1141
2024-2025,Sevilla,50.5,39,32,71,37,2,3,98,8,42.7,40.3,30.8,71.1,594,1193,49.5,54,37,91,49,5,6,93,4,47.4,42.7,34.0,76.7,551,1262
2024-2025,Valencia,48.4,43,26,69,38,5,5,86,1,43.2,39.3,30.0,69.3,572,1340,51.6,51,38,89,45,6,9,86,3,51.9,44.9,37.2,82.0,589,1419
2024-2025,Valladolid,42.8,26,15,41,21,5,5,91,5,34.6,30.7,25.7,56.4,476,991,57.2,89,62,151,82,7,7,86,3,67.6,62.4,46.8,109.2,724,1753
2024-2025,Villarreal,47.6,69,51,120,64,5,7,96,4,64.8,59.1,49.7,108.8,693,1522,52.4,50,28,78,43,7,8,99,7,44.4,38.2,28.5,66.7,720,1597
2023-2024,AlavÃ©s,41.8,33,28,61,30,3,7,84,1,46.2,40.7,32.4,73.0,550,1260,58.2,44,29,73,36,8,8,102,7,44.7,38.5,29.8,68.3,744,1502
2023-2024,AlmerÃ­a,46.4,42,25,67,40,2,2,93,6,48.7,47.1,34.2,81.4,590,1097,53.6,75,56,131,69,6,9,72,4,61.6,54.5,45.3,99.8,751,1644
2023-2024,Athletic Club,49.8,59,41,100,56,3,5,80,5,52.7,48.7,37.0,85.8,735,1610,50.2,33,27,60,32,1,5,82,3,41.3,37.5,32.0,69.5,521,1298
2023-2024,AtlÃ©tico Madrid,50.8,68,48,116,63,5,6,89,5,62.4,57.9,47.4,105.2,758,1597,49.2,43,33,76,42,1,2,79,2,39.5,37.9,29.7,67.6,648,1544
2023-2024,Barcelona,64.3,76,55,131,70,6,7,87,2,77.6,72.1,57.4,129.5,964,1925,35.7,44,35,79,42,2,2,98,8,41.6,40.1,30.9,71.0,487,992
2023-2024,Betis,50.4,46,31,77,44,2,3,87,3,43.9,41.7,32.7,74.4,676,1441,49.6,42,23,65,35,7,8,97,5,50.2,44.0,32.6,76.5,649,1457
2023-2024,CÃ¡diz,43.3,25,17,42,22,3,3,107,7,36.0,33.6,25.2,58.9,456,1017,56.7,54,37,91,52,2,2,97,4,52.3,50.7,40.2,90.9,787,1679
2023-2024,Celta Vigo,46.1,45,35,80,42,3,5,66,5,50.7,46.9,38.2,85.1,660,1345,53.9,54,32,86,48,6,8,89,4,54.6,48.4,35.9,84.3,651,1535
2023-2024,Getafe,44.8,42,27,69,36,6,7,135,10,45.7,40.2,27.9,68.0,439,1141,55.2,54,37,91,49,5,7,105,10,53.8,48.3,38.0,86.3,599,1325
2023-2024,Girona,56.9,84,64,148,77,7,8,75,1,70.8,64.6,54.0,118.6,894,1685,43.1,46,30,76,41,5,7,104,5,54.3,48.9,37.7,86.6,610,1277
2023-2024,Granada,45.6,35,27,62,30,5,8,98,4,42.6,36.4,31.1,67.6,512,1044,54.4,77,54,131,72,5,6,92,5,64.2,59.5,43.8,103.2,728,1490
2023-2024,Las Palmas,59.2,33,23,56,30,3,5,84,5,33.2,29.2,23.3,52.5,577,1596,40.8,44,33,77,39,5,9,97,5,56.6,49.7,41.8,91.4,584,1207
2023-2024,Mallorca,45.0,33,27,60,32,1,3,105,4,40.5,38.2,30.8,69.0,498,1174,55.0,43,29,72,39,4,5,53,1,42.9,39.0,28.5,67.5,663,1399
2023-2024,Osasuna,47.5,45,32,77,41,4,5,78,5,40.5,36.6,28.5,65.1,501,1322,52.5,56,44,100,55,1,2,92,6,49.9,48.5,38.3,86.8,646,1427
2023-2024,Rayo Vallecano,49.4,29,12,41,23,6,6,108,5,42.3,37.7,24.6,62.3,506,1335,50.6,46,36,82,45,1,2,105,7,44.6,43.1,36.3,79.4,658,1371
2023-2024,Real Madrid,59.2,85,66,151,83,2,5,69,4,68.8,65.2,52.5,117.7,950,1935,40.8,25,17,42,24,1,1,95,0,35.4,34.7,26.4,61.1,583,1261
2023-2024,Real Sociedad,55.3,48,36,84,44,4,4,98,2,44.9,41.8,30.7,72.5,685,1414,44.7,38,24,62,32,6,7,100,6,41.3,36.0,24.6,60.5,405,941
2023-2024,Sevilla,50.3,46,30,76,44,2,2,108,4,44.9,43.3,31.7,75.0,635,1416,49.7,52,40,92,47,5,5,81,3,55.9,52.1,42.0,94.1,693,1483
2023-2024,Valencia,44.3,39,24,63,31,8,9,64,5,43.1,36.2,27.0,63.2,522,1162,55.7,43,31,74,40,3,6,102,5,47.6,42.9,32.8,75.7,621,1587
2023-2024,Villarreal,49.6,64,47,111,59,5,7,110,8,55.6,50.1,40.5,90.6,654,1558,50.4,64,48,112,58,6,6,91,2,58.7,54.0,40.6,94.6,734,1655
2022-2023,AlmerÃ­a,45.1,49,33,82,47,2,3,98,4,45.5,43.2,32.5,75.6,569,1090,54.9,64,49,113,60,4,6,93,5,62.5,57.8,49.5,107.4,860,1707
2022-2023,Athletic Club,51.6,46,33,79,41,5,7,81,5,54.2,48.7,38.9,87.6,864,1816,48.4,40,28,68,37,3,3,97,3,36.9,34.5,26.9,61.4,549,1212
2022-2023,AtlÃ©tico Madrid,50.6,68,51,119,67,1,1,92,8,61.9,61.1,48.0,109.1,730,1571,49.4,33,22,55,29,4,5,93,6,41.1,37.2,31.3,68.5,729,1634
2022-2023,Barcelona,64.3,69,56,125,69,0,2,84,6,75.5,74.0,60.1,134.1,961,2182,35.7,17,10,27,14,3,3,93,8,33.2,30.8,23.0,53.9,475,955
2022-2023,Betis,50.6,43,26,69,35,8,9,83,15,51.3,44.3,34.6,78.9,621,1272,49.4,40,28,68,37,3,3,99,8,50.0,47.7,37.0,84.7,749,1571
2022-2023,CÃ¡diz,41.9,29,20,49,25,4,5,116,7,41.5,37.7,27.7,65.4,475,969,58.1,53,32,85,44,9,10,100,11,61.6,53.8,38.4,92.3,823,1739
2022-2023,Celta Vigo,50.2,41,31,72,39,2,3,85,6,42.6,40.3,30.8,71.1,704,1403,49.8,52,35,87,47,5,8,112,9,45.4,39.2,30.5,69.7,536,1297
2022-2023,Elche,45.5,30,21,51,26,4,5,99,12,37.5,33.6,27.1,60.7,561,1197,54.5,65,44,109,58,7,10,83,8,70.0,62.1,48.7,110.9,737,1615
2022-2023,Espanyol,43.1,51,31,82,46,5,5,99,10,48.3,44.4,35.0,79.4,528,1146,56.9,67,47,114,62,5,6,111,8,59.8,55.3,44.6,99.8,748,1634
2022-2023,Getafe,39.9,34,21,55,29,5,8,126,9,36.7,30.4,22.5,53.0,365,1003,60.1,43,29,72,39,4,8,91,7,46.0,39.8,31.0,70.8,688,1519
2022-2023,Girona,51.3,55,41,96,47,8,9,92,3,50.6,43.8,37.5,81.3,725,1378,48.7,55,39,94,49,6,8,91,5,54.9,48.6,38.6,87.2,677,1439
2022-2023,Mallorca,41.1,36,27,63,32,4,5,120,5,35.2,31.1,26.5,57.7,476,948,58.9,43,31,74,37,6,7,94,4,46.4,41.0,31.8,72.8,795,1706
2022-2023,Osasuna,48.0,36,30,66,32,4,5,93,7,39.8,35.9,28.4,64.3,545,1356,52.0,40,29,69,39,1,4,81,9,45.7,42.5,34.8,77.3,680,1371
2022-2023,Rayo Vallecano,51.2,41,29,70,37,4,8,90,6,43.9,37.8,30.0,67.8,703,1390,48.8,49,34,83,45,4,5,93,7,50.3,46.6,36.8,83.4,589,1231
2022-2023,Real Madrid,60.9,73,56,129,64,9,12,72,3,75.5,66.1,56.8,122.9,1008,2017,39.1,35,21,56,31,4,5,97,7,38.9,35.0,27.8,62.8,631,1189
2022-2023,Real Sociedad,54.6,47,36,83,45,2,4,90,2,52.9,49.7,39.7,89.4,692,1483,45.4,33,26,59,32,1,2,98,10,33.0,31.5,24.8,56.3,575,1025
2022-2023,Sevilla,52.6,47,31,78,43,4,5,121,13,46.3,42.4,32.0,74.5,558,1513,47.4,51,40,91,49,2,3,95,8,54.2,51.8,42.0,93.7,643,1275
2022-2023,Valencia,52.0,40,23,63,35,5,8,93,8,49.3,43.0,32.5,75.5,786,1472,48.0,43,34,77,41,2,5,127,10,43.5,39.7,32.3,72.0,480,1225
2022-2023,Valladolid,48.7,32,24,56,29,3,4,94,6,38.5,35.4,28.4,63.7,610,1244,51.3,62,46,108,56,6,10,66,2,65.2,57.5,46.7,104.2,723,1486
2022-2023,Villarreal,56.9,57,33,90,53,4,7,91,4,61.6,56.1,43.2,99.3,846,1622,43.1,39,29,68,35,4,4,105,5,49.9,46.7,35.7,82.4,640,1242
2021-2022,AlavÃ©s,42.0,29,20,49,23,6,7,93,4,37.3,31.8,25.5,57.3,420,984,58.2,65,48,113,59,6,9,79,4,57.0,50.0,42.0,92.0,656,1568
2021-2022,Athletic Club,48.1,40,34,74,37,3,7,90,4,49.6,44.0,37.5,81.6,653,1572,51.9,35,26,61,32,3,3,105,9,38.4,36.0,27.7,63.7,586,1379
2021-2022,AtlÃ©tico Madrid,50.6,63,45,108,59,4,5,111,7,54.4,50.6,40.2,90.8,705,1463,49.4,40,28,68,33,7,8,102,4,33.4,27.4,20.8,48.2,495,1320
2021-2022,Barcelona,64.2,68,52,120,62,6,7,97,5,63.4,57.9,47.6,105.5,961,2079,35.2,38,27,65,36,2,3,93,5,34.4,32.1,24.7,56.8,448,938
2021-2022,Betis,53.7,60,45,105,54,6,6,87,6,53.5,48.8,37.7,86.5,666,1518,45.9,38,29,67,35,3,3,74,3,43.4,41.1,30.2,71.3,686,1375
2021-2022,CÃ¡diz,41.3,35,21,56,32,3,6,105,3,39.5,34.8,24.6,59.4,571,1080,59.1,51,31,82,40,11,13,98,6,48.3,38.2,30.4,68.5,735,1805
2021-2022,Celta Vigo,55.2,43,29,72,40,3,6,87,3,43.1,38.3,28.8,67.2,665,1447,44.4,41,29,70,37,4,8,103,5,45.7,39.4,28.7,68.0,547,1251
2021-2022,Elche,48.4,39,29,68,38,1,1,104,6,33.7,32.9,27.6,60.5,531,1102,51.6,52,41,93,45,7,9,80,2,59.1,52.1,41.7,93.8,657,1477
2021-2022,Espanyol,46.9,39,25,64,34,5,5,99,7,36.7,32.9,25.8,58.7,610,1212,52.9,51,39,90,47,4,5,120,7,51.2,47.3,36.7,84.1,800,1705
2021-2022,Getafe,41.5,31,26,57,28,3,5,121,8,29.3,25.3,19.4,44.7,399,917,58.8,40,30,70,38,2,4,110,4,38.6,35.5,27.4,63.0,612,1521
2021-2022,Granada,44.7,43,28,71,40,3,5,105,4,39.0,35.1,26.7,61.8,435,1047,66.0,59,46,105,52,7,9,101,9,61.2,54.6,44.6,99.2,706,1611
2021-2022,Levante,47.2,51,34,85,43,8,13,109,6,55.1,45.1,31.7,76.9,569,1343,53.1,76,59,135,71,5,6,104,5,55.0,50.2,41.2,91.4,716,1448
2021-2022,Mallorca,45.3,33,23,56,27,6,7,114,7,38.8,33.3,25.7,59.0,575,1129,54.9,59,40,99,53,6,8,114,6,49.3,43.0,33.8,76.8,650,1379
2021-2022,Osasuna,46.9,37,23,60,31,6,8,84,2,36.7,30.7,22.9,53.6,417,1328,53.3,49,37,86,45,4,7,73,1,46.3,40.8,32.5,73.2,722,1330
2021-2022,Rayo Vallecano,49.9,38,28,66,34,4,4,101,3,42.8,39.7,30.7,70.3,697,1312,50.1,49,33,82,42,7,9,110,3,48.4,41.5,34.7,76.1,603,1330
2021-2022,Real Madrid,59.9,80,59,139,72,8,12,76,0,71.7,62.2,50.7,112.9,1029,2078,34.0,31,20,51,28,3,5,82,3,43.9,39.8,32.2,72.0,632,1257
2021-2022,Real Sociedad,54.3,40,22,62,31,9,10,77,4,51.5,43.8,32.9,76.7,667,1462,45.3,37,28,65,32,5,6,95,2,38.7,34.0,28.1,62.1,587,1206
2021-2022,Sevilla,59.4,51,40,91,49,2,3,97,4,42.4,40.0,32.5,72.5,625,1596,40.2,30,19,49,28,2,4,98,4,36.9,33.8,25.0,58.9,521,1182
2021-2022,Valencia,43.6,45,30,75,37,8,9,134,8,39.0,32.2,25.4,57.6,554,1202,56.4,50,34,84,43,7,8,133,7,47.7,41.6,32.3,73.8,597,1392
2021-2022,Villarreal,56.8,62,51,113,57,5,6,81,1,64.2,60.0,50.9,110.9,790,1698,43.0,36,20,56,32,4,5,98,3,44.8,41.1,30.2,71.4,583,1095
2020-2021,AlavÃ©s,42.8,35,21,56,30,5,8,96,8,42.6,36.4,27.4,63.7,404,939,57.3,57,44,101,54,3,3,80,3,49.9,47.5,37.1,84.7,632,1479
2020-2021,Athletic Club,49.9,43,31,74,39,4,5,82,3,42.8,38.9,31.0,70.0,685,1496,50.2,41,29,70,36,5,6,80,5,37.5,32.9,27.1,60.0,589,1380
2020-2021,AtlÃ©tico Madrid,52.3,65,54,119,60,5,7,100,0,52.8,47.2,40.6,87.8,694,1604,47.6,22,15,37,21,1,4,59,3,37.1,34.0,27.7,61.7,557,1394
2020-2021,Barcelona,65.5,80,51,131,76,4,8,72,2,73.5,67.1,53.2,120.2,972,2157,45.0,36,20,56,31,5,5,76,6,40.8,36.9,25.4,62.3,529,1038
2020-2021,Betis,53.6,50,35,85,42,8,11,93,8,49.1,40.6,33.4,74.0,694,1442,46.1,47,31,78,39,8,10,83,2,46.8,39.2,30.1,69.3,551,1311
2020-2021,CÃ¡diz,34.8,33,16,49,29,4,4,81,3,34.7,31.6,20.4,52.0,455,854,65.7,57,41,98,48,9,10,87,4,55.4,47.6,39.3,86.9,820,1881
2020-2021,Celta Vigo,53.3,55,39,94,48,7,7,109,5,50.4,44.9,36.7,81.6,514,1308,46.3,56,37,93,49,7,8,102,6,51.0,45.0,35.7,80.7,578,1249
2020-2021,Eibar,49.3,29,20,49,25,4,9,71,3,45.2,38.3,29.9,68.2,507,1295,50.4,52,40,92,49,3,5,66,2,45.7,41.7,35.2,77.0,446,1056
2020-2021,Elche,47.5,33,25,58,31,2,3,99,3,29.9,27.5,21.8,49.4,501,929,52.4,54,43,97,48,6,10,79,2,60.9,53.2,44.0,97.2,702,1647
2020-2021,Getafe,43.3,27,14,41,24,3,5,120,7,34.4,30.5,23.6,54.1,443,1090,57.2,40,26,66,33,7,8,106,6,40.3,34.0,25.8,59.8,454,1195
2020-2021,Granada,41.4,47,30,77,44,3,5,97,6,41.1,37.3,26.8,64.0,411,975,59.0,64,41,105,58,6,12,104,6,56.2,46.8,38.2,85.0,636,1449
2020-2021,Huesca,48.3,32,23,55,29,3,4,69,2,38.7,35.9,26.6,62.5,617,1185,51.7,51,37,88,46,5,5,64,2,48.1,44.3,35.6,80.0,657,1447
2020-2021,Levante,52.2,45,35,80,42,3,6,68,1,40.4,35.7,29.6,65.3,621,1537,47.6,55,42,97,52,3,4,87,7,53.5,50.6,40.0,90.6,625,1299
2020-2021,Osasuna,43.2,36,25,61,31,5,6,80,5,38.7,34.7,24.9,59.7,345,1220,56.9,46,31,77,41,5,8,65,0,47.8,41.5,33.2,74.6,678,1525
2020-2021,Real Madrid,59.3,64,53,117,61,3,3,59,2,61.5,59.2,47.4,106.5,963,1920,40.3,27,17,44,20,7,8,87,3,37.6,31.3,24.4,55.7,545,1157
2020-2021,Real Sociedad,54.9,58,39,97,49,9,12,81,1,60.7,51.5,39.6,91.1,626,1554,44.9,37,24,61,34,3,5,91,6,39.2,35.3,26.1,61.4,436,1011
2020-2021,Sevilla,60.9,52,36,88,46,6,7,79,2,54.4,48.9,41.0,90.0,691,1627,55.0,31,20,51,27,4,6,109,1,34.8,30.1,22.5,52.6,544,1103
2020-2021,Valencia,46.9,48,35,83,40,8,10,82,5,42.6,34.8,27.2,62.1,576,1180,53.1,51,29,80,46,5,8,99,5,52.2,46.2,33.8,80.0,713,1644
2020-2021,Valladolid,45.2,34,21,55,27,7,8,93,4,40.1,33.8,24.2,58.0,564,1101,54.9,57,44,101,51,6,7,96,2,52.9,47.4,38.3,85.6,693,1549
2020-2021,Villarreal,55.2,57,33,90,45,12,13,67,5,56.4,46.4,40.5,86.9,737,1628,44.4,42,25,67,35,7,9,78,4,42.5,35.6,26.2,61.8,635,1227
2019-2020,AlavÃ©s,41.5,34,20,54,28,6,6,111,7,39.3,34.7,26.9,61.6,403,944,58.5,59,36,95,47,12,15,87,3,57.8,46.3,37.1,83.5,656,1548
2019-2020,Athletic Club,48.7,40,23,63,32,8,10,90,2,41.5,33.8,26.2,60.0,604,1291,51.3,36,26,62,31,5,7,89,0,48.8,43.7,34.6,78.3,615,1390
2019-2020,AtlÃ©tico Madrid,48.6,50,35,85,44,6,8,93,3,56.8,50.6,39.4,90.0,598,1333,51.4,24,15,39,21,3,4,113,4,32.5,29.5,22.9,52.5,619,1523
2019-2020,Barcelona,66.4,84,62,146,78,6,6,92,6,66.3,61.7,49.5,111.2,923,2042,33.6,38,21,59,32,6,7,89,4,38.3,32.9,23.6,56.5,576,1003
2019-2020,Betis,56.7,48,35,83,42,6,8,108,9,51.0,45.2,36.9,82.0,834,1475,43.3,59,40,99,48,11,11,111,5,54.8,46.2,36.1,82.3,613,1263
2019-2020,Celta Vigo,51.7,37,26,63,31,6,9,104,6,39.2,32.4,26.2,58.7,670,1364,48.4,49,31,80,44,5,5,119,5,45.3,41.4,33.4,74.7,679,1436
2019-2020,Eibar,46.3,38,24,62,31,7,10,92,3,42.0,34.2,26.0,60.2,424,1265,53.7,55,38,93,51,4,6,70,2,53.0,48.4,40.0,88.5,561,1177
2019-2020,Espanyol,47.4,25,17,42,21,4,4,107,9,38.6,35.6,27.3,62.9,561,1240,52.6,56,35,91,50,6,7,75,6,51.0,45.8,34.9,80.8,688,1452
2019-2020,Getafe,45.0,42,31,73,36,6,7,135,5,41.6,36.1,27.9,64.0,416,1196,55.0,35,21,56,30,5,6,122,11,41.4,36.7,29.5,66.1,376,1089
2019-2020,Granada,43.8,50,34,84,45,5,5,109,1,44.9,40.9,30.5,71.4,511,1009,56.2,45,37,82,41,4,5,116,7,42.6,38.6,33.1,71.7,672,1397
2019-2020,LeganÃ©s,43.9,30,19,49,27,3,5,127,4,39.9,35.9,27.7,63.7,498,1165,56.1,50,34,84,44,6,7,105,5,42.8,37.4,29.7,67.1,632,1423
2019-2020,Levante,48.3,45,28,73,40,5,5,79,5,48.1,44.2,36.3,80.5,711,1358,51.7,51,40,91,48,3,7,96,1,62.9,57.4,47.2,104.7,741,1499
2019-2020,Mallorca,45.0,39,21,60,31,8,10,93,5,41.1,33.3,25.4,58.7,740,1210,55.0,64,39,103,49,15,16,118,4,63.5,51.2,43.2,94.4,774,1681
2019-2020,Osasuna,47.4,46,26,72,38,8,8,110,6,49.4,43.2,34.4,77.6,562,1359,52.6,54,39,93,49,5,5,83,4,49.4,45.5,35.9,81.4,581,1311
2019-2020,Real Madrid,58.8,69,52,121,58,11,11,82,4,67.9,59.2,49.9,109.1,951,1972,41.2,25,21,46,23,2,2,87,1,33.3,31.7,23.9,55.6,604,1211
2019-2020,Real Sociedad,56.2,54,38,92,50,4,5,79,2,48.9,45.1,35.4,80.5,737,1588,43.8,47,33,80,40,7,9,101,7,43.0,36.0,27.7,63.7,546,1133
2019-2020,Sevilla,57.9,53,35,88,46,7,7,97,1,53.2,47.9,38.4,86.3,803,1823,42.1,33,21,54,30,3,4,100,5,36.1,33.0,24.4,57.4,552,1138
2019-2020,Valencia,49.0,45,34,79,40,5,8,80,8,43.3,37.2,31.7,68.9,671,1378,51.0,52,31,83,45,7,9,90,4,56.0,49.1,35.3,84.4,863,1698
2019-2020,Valladolid,44.7,31,19,50,28,3,6,84,0,36.6,32.1,24.0,56.1,510,1106,55.3,43,26,69,36,7,8,95,4,54.5,48.4,38.7,87.1,797,1764
2019-2020,Villarreal,52.9,62,40,102,52,10,11,78,1,63.6,55.2,43.1,98.3,694,1483,47.1,47,35,82,39,8,9,84,5,46.3,39.3,31.9,71.1,676,1465
2018-2019,AlavÃ©s,42.7,39,27,66,37,2,3,101,1,41.1,38.8,29.0,67.8,511,1113,57.3,48,31,79,42,6,6,93,2,53.2,48.6,36.6,85.2,714,1843
2018-2019,Athletic Club,50.0,39,26,65,34,5,7,120,4,43.4,37.8,30.7,68.5,626,1452,50.0,45,32,77,40,5,5,106,2,45.7,41.8,33.9,75.6,677,1317
2018-2019,AtlÃ©tico Madrid,49.2,53,36,89,50,3,4,103,5,47.3,44.1,35.3,79.5,677,1386,50.8,27,15,42,22,5,5,95,3,41.9,38.1,29.2,67.3,662,1651
2018-2019,Barcelona,64.4,88,61,149,80,8,9,77,2,75.8,68.7,55.8,124.6,851,2110,35.6,35,25,60,33,2,2,102,5,45.3,43.7,34.3,78.0,558,1092
2018-2019,Betis,61.8,43,30,73,38,5,7,89,1,47.1,41.5,32.9,74.4,887,1631,38.2,52,42,94,48,4,5,123,7,49.4,45.5,37.2,82.7,577,1153
2018-2019,Celta Vigo,51.6,52,37,89,45,7,7,84,6,46.5,41.2,33.6,74.8,673,1288,48.4,61,41,102,55,6,7,89,2,60.9,55.4,43.5,98.9,721,1503
2018-2019,Eibar,54.0,46,26,72,39,7,8,82,2,54.8,48.6,36.7,85.3,565,1619,46.0,49,39,88,46,3,4,76,2,45.9,42.7,37.2,79.9,459,1070
2018-2019,Espanyol,49.4,43,26,69,39,4,4,92,2,48.9,45.8,33.8,79.6,642,1495,50.6,48,26,74,42,6,8,111,6,53.8,47.5,35.9,83.4,799,1585
2018-2019,Getafe,40.7,47,34,81,41,6,6,111,7,46.2,41.6,32.9,74.4,448,1131,59.3,33,18,51,29,4,7,109,5,43.6,38.7,29.8,68.5,525,1385
2018-2019,Girona,48.0,37,23,60,31,6,6,83,4,43.5,39.3,29.3,68.6,634,1316,52.0,51,34,85,43,8,8,116,7,52.7,46.9,38.0,84.9,809,1624
2018-2019,Huesca,44.5,43,28,71,37,6,7,114,3,50.8,45.4,34.6,80.0,653,1209,55.5,62,46,108,53,9,9,86,4,60.2,53.1,43.1,96.3,768,1576
2018-2019,LeganÃ©s,43.1,36,25,61,33,3,5,106,4,40.6,36.8,28.1,64.9,447,1153,56.9,42,27,69,39,3,4,90,3,41.2,37.9,28.6,66.5,705,1596
2018-2019,Levante,45.7,56,39,95,51,5,7,112,7,53.9,48.4,38.5,86.9,709,1295,54.3,64,41,105,56,8,9,92,7,76.2,69.1,51.4,120.4,868,1553
2018-2019,Rayo Vallecano,48.7,40,24,64,35,5,5,106,8,48.7,44.8,33.0,77.7,831,1326,51.3,69,51,120,62,7,11,73,3,60.0,51.5,41.0,92.5,660,1557
2018-2019,Real Madrid,60.1,61,39,100,52,9,9,83,6,66.7,60.2,49.9,110.1,1009,2094,39.9,46,32,78,40,6,8,93,3,47.1,41.7,33.0,74.7,615,1158
2018-2019,Real Sociedad,51.7,44,27,71,36,8,10,82,4,49.7,42.2,33.0,75.2,695,1381,48.3,44,30,74,42,2,3,107,3,48.6,46.1,34.2,80.2,657,1407
2018-2019,Sevilla,52.3,60,47,107,55,5,6,118,6,66.6,61.8,49.3,111.1,828,1804,47.7,47,29,76,41,6,7,99,3,45.4,39.9,31.2,71.1,696,1407
2018-2019,Valencia,47.1,50,38,88,45,5,7,90,3,60.7,55.2,46.7,101.9,751,1561,52.9,33,19,52,26,7,8,113,4,42.9,36.7,26.7,63.5,791,1632
2018-2019,Valladolid,46.8,31,19,50,27,4,7,92,0,41.1,35.6,26.7,62.3,662,1299,53.2,50,36,86,44,6,9,106,5,58.5,51.7,43.1,94.8,800,1642
2018-2019,Villarreal,48.3,47,34,81,44,3,6,118,3,53.9,50.0,39.0,89.0,715,1648,51.7,49,32,81,46,3,5,84,2,55.0,51.1,41.0,92.1,753,1560
2017-2018,AlavÃ©s,40.3,40,31,71,39,1,3,109,4,38.5,36.1,27.7,63.8,454,1045,59.7,48,28,76,41,7,10,84,4,55.9,48.6,38.8,87.4,751,1842
2017-2018,Athletic Club,49.6,39,25,64,33,6,8,93,0,49.7,43.8,33.7,77.5,652,1519,50.4,46,33,79,43,3,6,106,8,50.3,45.6,37.1,82.6,666,1311
2017-2018,AtlÃ©tico Madrid,47.5,57,41,98,53,4,5,96,5,50.2,46.3,36.6,82.9,703,1460,52.5,21,17,38,20,1,4,98,0,35.8,32.6,27.6,60.2,737,1677
2017-2018,Barcelona,62.8,96,74,170,93,3,5,67,2,83.5,80.1,64.6,144.7,1025,2151,37.2,29,22,51,27,2,2,99,4,41.9,40.5,32.3,72.8,632,1190
2017-2018,Betis,56.9,56,43,99,54,2,3,91,3,46.0,43.7,35.2,78.9,736,1506,43.1,57,45,102,54,3,4,96,4,49.0,45.8,35.9,81.7,622,1354
2017-2018,Celta Vigo,55.7,57,45,102,55,2,3,85,1,55.0,52.6,43.0,95.6,724,1595,44.3,59,48,107,55,4,5,97,1,55.3,51.4,41.5,92.9,611,1361
2017-2018,Eibar,52.0,43,31,74,41,2,3,86,3,40.9,38.6,30.2,68.8,635,1468,48.0,47,36,83,43,4,4,78,6,44.4,41.3,34.4,75.7,488,1056
2017-2018,Espanyol,46.9,33,24,57,31,2,3,88,1,41.1,38.7,27.8,66.4,532,1276,53.1,40,26,66,36,4,6,113,3,52.3,47.5,35.9,83.5,706,1615
2017-2018,Getafe,40.2,41,27,68,36,5,12,134,5,48.2,38.6,29.6,68.2,374,1092,59.8,33,28,61,31,2,4,107,3,39.7,36.6,29.9,66.5,660,1580
2017-2018,Girona,46.8,50,31,81,44,6,8,102,0,50.6,44.4,34.4,78.8,590,1215,53.2,56,39,95,52,4,5,112,3,50.4,46.5,34.6,81.1,721,1436
2017-2018,La CoruÃ±a,46.8,38,30,68,35,3,5,100,2,51.6,47.7,40.0,87.7,640,1477,53.2,73,53,126,69,4,5,75,2,58.7,54.8,43.3,98.1,774,1709
2017-2018,Las Palmas,54.7,24,15,39,18,6,8,89,3,38.5,32.3,24.8,57.1,726,1332,45.3,73,53,126,68,5,5,103,7,70.5,66.6,55.5,122.2,766,1410
2017-2018,LeganÃ©s,43.0,32,23,55,30,2,3,105,5,39.9,37.6,30.0,67.6,534,1111,57.0,51,28,79,45,6,7,82,4,47.6,42.2,31.5,73.7,645,1468
2017-2018,Levante,42.8,43,28,71,38,5,5,111,6,44.7,40.8,31.8,72.7,676,1286,57.2,55,41,96,50,5,6,93,6,63.6,58.8,45.3,104.1,758,1661
2017-2018,MÃ¡laga,44.1,23,15,38,19,4,6,101,8,38.4,33.7,26.3,60.0,463,1169,55.9,61,44,105,55,6,7,76,0,59.4,53.8,43.1,97.0,777,1777
2017-2018,Real Madrid,60.2,91,65,156,83,8,10,67,4,85.4,77.5,62.8,140.2,1131,2383,39.8,42,34,76,40,2,4,97,3,43.2,40.6,31.5,72.1,598,1229
2017-2018,Real Sociedad,56.5,64,47,111,60,4,5,64,5,53.7,49.7,38.9,88.7,883,1605,43.5,58,41,99,52,6,8,94,1,50.5,44.1,35.5,79.7,577,1244
2017-2018,Sevilla,54.3,48,35,83,44,4,5,99,3,59.5,55.7,42.8,98.5,817,1824,45.7,57,39,96,52,5,8,80,3,54.4,48.1,36.6,84.7,731,1410
2017-2018,Valencia,48.6,63,45,108,55,8,8,107,5,56.0,49.8,39.9,89.7,739,1563,51.4,38,28,66,35,3,5,97,5,48.3,44.4,35.2,79.7,728,1613
2017-2018,Villarreal,50.4,56,45,101,52,4,5,117,6,53.3,49.3,42.0,91.3,719,1453,49.6,50,37,87,45,5,8,83,4,53.4,47.2,36.2,83.4,805,1587
2024-2025-femenino,Athletic Club,52.6,38,24,62,34,4,4,42,1,34.5,31.6,22.4,53.9,302,1110,47.4,29,18,47,28,1,1,47,1,32.0,31.3,22.8,54.1,382,1117
2024-2025-femenino,AtlÃ©tico Madrid,59.1,46,35,81,44,2,2,50,1,41.4,39.9,30.8,70.7,494,1603,40.9,22,15,37,21,1,1,55,2,28.3,27.6,19.6,47.2,339,814
2024-2025-femenino,Barcelona,74.4,127,90,217,120,7,7,20,0,109.0,103.9,81.8,185.8,765,2601,25.6,16,9,25,16,0,0,27,2,12.7,12.7,7.8,20.5,154,273
2024-2025-femenino,Dep La CoruÃ±a,45.0,26,18,44,25,1,2,45,1,25.2,23.6,17.6,41.2,349,762,55.0,47,32,79,46,1,1,61,2,50.9,50.1,37.7,87.8,525,1513
2024-2025-femenino,Eibar,34.4,24,16,40,21,3,4,43,1,22.2,19.3,12.3,31.7,185,589,65.6,41,33,74,39,2,2,41,2,43.9,42.4,31.9,74.3,555,1660
2024-2025-femenino,Espanyol,35.2,28,20,48,27,1,2,66,4,27.1,25.6,17.8,43.4,303,626,64.8,48,29,77,44,4,6,63,3,48.8,44.3,33.1,77.4,419,1356
2024-2025-femenino,Granada,53.7,41,26,67,37,4,4,50,1,35.5,32.6,26.0,58.6,425,1094,46.3,43,31,74,41,2,3,39,0,42.6,40.4,29.5,69.9,368,1030
2024-2025-femenino,Levante,51.1,30,18,48,28,2,2,49,4,27.6,26.2,20.0,46.1,363,1083,48.9,45,33,78,44,1,4,45,2,48.1,45.1,33.9,79.1,426,1216
2024-2025-femenino,Levante Planas,50.7,24,11,35,19,5,6,60,1,34.6,30.2,21.9,52.1,447,1175,49.3,44,34,78,42,2,2,57,1,32.7,31.2,24.8,56.0,339,919
2024-2025-femenino,Madrid CFF,49.4,36,27,63,35,1,1,39,0,34.1,33.4,25.3,58.7,410,884,50.6,61,42,103,57,4,4,46,1,41.5,38.7,30.5,69.1,374,1159
2024-2025-femenino,Real Betis,46.9,23,14,37,21,2,2,71,3,22.8,21.4,15.4,36.8,271,877,53.1,64,39,103,59,5,6,61,1,56.5,51.9,37.4,89.3,464,1300
2024-2025-femenino,Real Madrid,60.6,83,57,140,79,4,8,38,0,76.1,70.0,53.6,123.6,682,1858,39.4,25,12,37,20,5,5,47,2,22.1,18.4,12.8,31.2,266,704
2024-2025-femenino,Real Sociedad,58.4,38,28,66,37,1,2,44,3,37.1,35.7,28.2,63.8,416,1357,41.6,43,30,73,37,6,6,50,2,38.4,34.1,28.8,62.9,331,921
2024-2025-femenino,Sevilla,43.2,31,17,48,30,1,1,60,4,32.2,31.4,20.8,52.2,298,721,56.8,47,29,76,46,1,3,40,1,38.4,36.2,26.4,62.6,430,1260
2024-2025-femenino,UDG Tenerife,44.6,39,26,65,36,3,4,43,2,32.5,29.6,21.7,51.3,309,851,55.4,36,25,61,33,3,4,46,2,36.6,33.7,24.1,57.8,465,1224
2024-2025-femenino,Valencia,40.8,23,16,39,21,2,4,62,1,25.4,22.4,15.4,37.8,335,793,59.2,46,32,78,41,5,7,57,3,44.0,38.7,29.8,68.5,517,1518
